,original_title,release_year,budget,revenue,profit
0,Jurassic World,2015,150000000,1513528810,1363528810
1,Mad Max: Fury Road,2015,150000000,378436354,228436354
2,Insurgent,2015,110000000,295238201,185238201
3,Star Wars: The Force Awakens,2015,200000000,2068178225,1868178225
4,Furious 7,2015,190000000,1506249360,1316249360
5,The Revenant,2015,135000000,532950503,397950503
6,Terminator Genisys,2015,155000000,440603537,285603537
7,The Martian,2015,108000000,595380321,487380321
8,Minions,2015,74000000,1156730962,1082730962
9,Inside Out,2015,175000000,853708609,678708609
10,Spectre,2015,245000000,880674609,635674609
11,Jupiter Ascending,2015,176000003,183987723,7987720
12,Ex Machina,2015,15000000,36869414,21869414
13,Pixels,2015,88000000,243637091,155637091
14,Avengers: Age of Ultron,2015,280000000,1405035767,1125035767
15,The Hateful Eight,2015,44000000,155760117,111760117
16,Taken 3,2015,48000000,325771424,277771424
17,Ant-Man,2015,130000000,518602163,388602163
18,Cinderella,2015,95000000,542351353,447351353
19,The Hunger Games: Mockingjay - Part 2,2015,160000000,650523427,490523427
20,Tomorrowland,2015,190000000,209035668,19035668
21,Southpaw,2015,30000000,91709827,61709827
22,San Andreas,2015,110000000,470490832,360490832
23,Fifty Shades of Grey,2015,40000000,569651467,529651467
24,The Big Short,2015,28000000,133346506,105346506
25,Mission: Impossible - Rogue Nation,2015,150000000,682330139,532330139
26,Ted 2,2015,68000000,215863606,147863606
27,Kingsman: The Secret Service,2015,81000000,403802136,322802136
28,Spotlight,2015,20000000,88346473,68346473
29,Maze Runner: The Scorch Trials,2015,61000000,311256926,250256926
31,Chappie,2015,49000000,102069268,53069268
32,Pitch Perfect 2,2015,29000000,287506194,258506194
33,Bridge of Spies,2015,40000000,162610473,122610473
34,Goosebumps,2015,58000000,150170815,92170815
35,Room,2015,6000000,35401758,29401758
37,The Good Dinosaur,2015,175000000,331926147,156926147
38,Run All Night,2015,50000000,71561644,21561644
39,Brooklyn,2015,11000000,62076141,51076141
40,Straight Outta Compton,2015,28000000,201634991,173634991
41,The Last Witch Hunter,2015,90000000,140396650,50396650
42,Steve Jobs,2015,30000000,34441873,4441873
43,The Man from U.N.C.L.E.,2015,75000000,108145109,33145109
44,The Age of Adaline,2015,25000000,42629776,17629776
45,Hardcore Henry,2015,10000000,14333790,4333790
46,Home,2015,135000000,368871007,233871007
47,Paper Towns,2015,12000000,85512300,73512300
49,The Lobster,2015,4000000,9064511,5064511
50,Carol,2015,11800000,40272135,28472135
51,The Intern,2015,35000000,194564672,159564672
52,Everest,2015,55000000,203427584,148427584
53,Joy,2015,60000000,101134059,41134059
54,Point Break,2015,105000000,133718711,28718711
55,Burnt,2015,20000000,36606743,16606743
56,Self/less,2015,26000000,30523226,4523226
57,Mortdecai,2015,60000000,30418560,-29581440
58,The Danish Girl,2015,15000000,64191523,49191523
59,Blackhat,2015,70000000,17752940,-52247060
60,Sicario,2015,30000000,84025816,54025816
61,Fantastic Four,2015,120000001,167977596,47977595
62,The Witch,2015,3500000,40423945,36923945
63,Spy,2015,65000000,235666219,170666219
64,Focus,2015,50100000,153962963,103862963
65,Hitman: Agent 47,2015,35000000,82347656,47347656
66,In the Heart of the Sea,2015,100000000,93820758,-6179242
68,Creed,2015,35000000,137935567,102935567
69,Trainwreck,2015,35000000,140795793,105795793
70,Eye in the Sky,2015,13000000,32848185,19848185
71,Legend,2015,25000000,42972994,17972994
73,Pan,2015,150000000,128388320,-21611680
76,The Peanuts Movie,2015,99000000,246233113,147233113
77,Concussion,2015,35000000,48623572,13623572
78,The Night Before,2015,25000000,52395996,27395996
79,Knock Knock,2015,2500000,5214043,2714043
80,The Longest Ride,2015,34000000,63013281,29013281
81,Hotel Transylvania 2,2015,80000000,466183544,386183544
82,Love the Coopers,2015,17000000,24000000,7000000
83,The Walk,2015,35000000,61181942,26181942
84,Tracers,2015,11000000,1863315,-9136685
85,Vacation,2015,31000000,104384188,73384188
86,Poltergeist,2015,35000000,95437994,60437994
89,Child 44,2015,50000000,3324330,-46675670
90,The Gift,2015,5000000,58978653,53978653
91,Daddy's Home,2015,50000000,240360392,190360392
94,The Little Prince,2015,64000000,97571250,33571250
96,The Dressmaker,2015,11930000,18340000,6410000
97,The DUFF,2015,8500000,43528634,35028634
98,Sinister 2,2015,10000000,52882018,42882018
99,Paul Blart: Mall Cop 2,2015,30000000,107597242,77597242
102,The Boy Next Door,2015,4000000,50163103,46163103
104,Entourage,2015,30000000,49263404,19263404
105,The Wedding Ringer,2015,23000000,79799880,56799880
106,Scouts Guide to the Zombie Apocalypse,2015,15000000,14860766,-139234
107,The Visit,2015,5000000,98450062,93450062
108,Black Mass,2015,53000000,99775678,46775678
110,Krampus,2015,15000000,61548707,46548707
112,No Escape,2015,5000000,54418872,49418872
113,Dope,2015,700000,17986781,17286781
114,American Ultra,2015,28000000,28208085,208085
115,Woman in Gold,2015,11000000,61619773,50619773
117,Sisters,2015,30000000,105011053,75011053
118,Project Almanac,2015,12000000,32248241,20248241
120,The Transporter Refueled,2015,25000000,72629670,47629670
121,Crimson Peak,2015,55000000,74679822,19679822
123,Magic Mike XXL,2015,14800000,122413057,107613057
124,Paranormal Activity: The Ghost Dimension,2015,10000000,78099553,68099553
126,Trumbo,2015,15000000,8235661,-6764339
127,Secret in Their Eyes,2015,19500000,32189727,12689727
129,The SpongeBob Movie: Sponge Out of Water,2015,74000000,311594032,237594032
131,Max,2015,20000000,43967255,23967255
135,The Gunman,2015,40000000,10664749,-29335251
136,Unfriended,2015,1000000,62882090,61882090
137,Hot Pursuit,2015,35000000,51680201,16680201
138,Insidious: Chapter 3,2015,10000000,104303851,94303851
141,The Lady in the Van,2015,6000000,41387687,35387687
142,Victor Frankenstein,2015,40000000,34227298,-5772702
144,Anomalisa,2015,8000000,3759286,-4240714
150,The Diary of a Teenage Girl,2015,2000000,1477002,-522998
155,Irrational Man,2015,11000000,27391084,16391084
157,Ricki and the Flash,2015,18000000,41325328,23325328
160,The Perfect Guy,2015,12000000,60273173,48273173
162,While We're Young,2015,10000000,7587485,-2412515
163,Get Hard,2015,40000000,106511453,66511453
167,The 33,2015,25000000,24902723,-97277
168,Suffragette,2015,14000000,16002420,2002420
170,We Are Your Friends,2015,6000000,11122090,5122090
179,The Second Best Exotic Marigold Hotel,2015,10000000,85978266,75978266
180,Little Boy,2015,20000000,6420319,-13579681
183,Aloha,2015,37000000,26250020,-10749980
186,Our Brand Is Crisis,2015,28000000,7002261,-20997739
200,Freeheld,2015,7000000,573335,-6426665
202,Love,2015,3000000,695269,-2304731
203,Truth,2015,9600000,2541554,-7058446
205,Danny Collins,2015,10000000,10835752,835752
206,Rock the Kasbah,2015,15000000,3020664,-11979336
208,"Hello, My Name Is Doris",2015,1000000,14444999,13444999
209,The Vatican Tapes,2015,13000000,1784763,-11215237
210,99 Homes,2015,8000000,1411927,-6588073
211,Hot Tub Time Machine 2,2015,14000000,12314651,-1685349
223,A Walk in the Woods,2015,8000000,35991087,27991087
225,The Lazarus Effect,2015,3300000,64110728,60810728
229,Unfinished Business,2015,35000000,14431253,-20568747
246,By the Sea,2015,10000000,3334927,-6665073
270,Black or White,2015,9000000,21571189,12571189
274,I Saw the Light,2015,13000000,1646788,-11353212
287,Jem and the Holograms,2015,5000000,2333684,-2666316
297,Demonic,2015,3000000,3387000,387000
350,Captive,2015,2000000,2801508,801508
380,90 Minutes in Heaven,2015,5000000,4842699,-157301
409,Grandma,2015,600000,7087452,6487452
492,War Room,2015,3000000,67790117,64790117
629,Interstellar,2014,165000000,621752480,456752480
630,Guardians of the Galaxy,2014,170000000,773312399,603312399
631,Captain America: The Winter Soldier,2014,170000000,714766572,544766572
632,John Wick,2014,20000000,78739897,58739897
633,The Hunger Games: Mockingjay - Part 1,2014,125000000,752100229,627100229
634,The Hobbit: The Battle of the Five Armies,2014,250000000,955119788,705119788
635,Big Hero 6,2014,165000000,652105443,487105443
636,The Imitation Game,2014,14000000,233555708,219555708
637,The Maze Runner,2014,34000000,348319861,314319861
638,Birdman,2014,18000000,103215094,85215094
639,Gone Girl,2014,61000000,369330363,308330363
640,Fury,2014,68000000,211817906,143817906
641,Night at the Museum: Secret of the Tomb,2014,127000000,349424282,222424282
642,Divergent,2014,85000000,288747895,203747895
643,X-Men: Days of Future Past,2014,250000000,746000000,496000000
644,Lucy,2014,40000000,463360063,423360063
645,Teenage Mutant Ninja Turtles,2014,125000000,477200000,352200000
646,Sex Tape,2014,40000000,126069509,86069509
647,Nightcrawler,2014,8500000,38697217,30197217
648,Transformers: Age of Extinction,2014,210000000,245500000,35500000
649,The Grand Budapest Hotel,2014,30000000,174600318,144600318
650,Whiplash,2014,3300000,13993093,10693093
651,Dawn of the Planet of the Apes,2014,170000000,708200000,538200000
652,The Equalizer,2014,55000000,192330738,137330738
653,Horrible Bosses 2,2014,42000000,106645357,64645357
654,The Amazing Spider-Man 2,2014,200000000,705717432,505717432
655,Edge of Tomorrow,2014,178000000,370541256,192541256
656,The Interview,2014,44000000,11305175,-32694825
657,American Sniper,2014,58800000,542307423,483507423
658,Exodus: Gods and Kings,2014,140000000,268031828,128031828
659,Godzilla,2014,160000000,529076069,369076069
660,Maleficent,2014,180000000,758410378,578410378
661,The November Man,2014,15000000,32556119,17556119
662,Ouija,2014,5000000,102529779,97529779
663,How to Train Your Dragon 2,2014,145000000,609123048,464123048
664,It Follows,2014,2000000,13500000,11500000
665,The Expendables 3,2014,90000000,206172544,116172544
666,The Lego Movie,2014,60000000,469160692,409160692
668,Seventh Son,2014,95000000,114178613,19178613
669,The Theory of Everything,2014,15000000,121201940,106201940
670,Let's Be Cops,2014,17000000,136621271,119621271
671,Dracula Untold,2014,70000000,215529201,145529201
672,Penguins of Madagascar,2014,132000000,373552094,241552094
673,Into the Woods,2014,50000000,212902372,162902372
674,300: Rise of an Empire,2014,110000000,337580051,227580051
675,The Giver,2014,25000000,66980456,41980456
676,22 Jump Street,2014,50000000,188441614,138441614
677,A Walk Among the Tombstones,2014,28000000,53181600,25181600
678,Paddington,2014,55000000,259207227,204207227
679,Cake,2014,7000000,2360281,-4639719
680,Chef,2014,11000000,45967935,34967935
681,The Purge: Anarchy,2014,9000000,108782847,99782847
682,Left Behind,2014,16000000,19682924,3682924
683,Boyhood,2014,4000000,44349000,40349000
684,A Most Violent Year,2014,20000000,12007070,-7992930
685,Hercules,2014,100000000,243400000,143400000
686,Noah,2014,125000000,362637473,237637473
687,The Judge,2014,50000000,83719388,33719388
689,Blended,2014,40000000,123494610,83494610
690,Neighbors,2014,18000000,268157400,250157400
691,If I Stay,2014,11000000,78874843,67874843
692,Step Up All In,2014,45000000,86165646,41165646
694,The Fault in Our Stars,2014,12000000,305151265,293151265
696,Ride Along,2014,25000000,153997819,128997819
698,Inherent Vice,2014,20000000,11110975,-8889025
699,Jack Ryan: Shadow Recruit,2014,60000000,50549107,-9450893
700,Non-Stop,2014,50000000,222809600,172809600
701,Predestination,2014,5500000,3000000,-2500000
704,The Drop,2014,12600000,18658381,6058381
705,RoboCop,2014,120000000,239379423,119379423
706,Transcendence,2014,100000000,103039258,3039258
707,The Other Woman,2014,40000000,196781193,156781193
708,Mr. Peabody & Sherman,2014,145000000,272912430,127912430
710,Sin City: A Dame to Kill For,2014,65000000,39407616,-25592384
712,Rio 2,2014,103000000,500188435,397188435
713,Dumb and Dumber To,2014,40000000,169837010,129837010
715,The Monuments Men,2014,70000000,154984035,84984035
716,Unbroken,2014,65000000,163442937,98442937
717,Selma,2014,20000000,66787908,46787908
718,Mommy,2014,4900000,3494070,-1405930
721,Wild,2014,15000000,52501541,37501541
722,Pompeii,2014,130000000,117831631,-12168369
723,The Best of Me,2014,26000000,35926213,9926213
724,Annie,2014,65000000,133821816,68821816
726,The Book of Life,2014,50000000,97437106,47437106
727,St. Vincent,2014,13000000,54837234,41837234
728,Need for Speed,2014,66000000,203277636,137277636
731,The Hundred-Foot Journey,2014,22000000,88880821,66880821
732,The Boxtrolls,2014,60000000,108255770,48255770
733,Big Eyes,2014,10000000,28883511,18883511
734,The Prince,2014,18000000,266586800,248586800
738,The Signal,2014,4000000,600896,-3399104
740,Into the Storm,2014,50000000,160602194,110602194
743,Planes: Fire & Rescue,2014,50000000,151165787,101165787
745,Sabotage,2014,35000000,17508518,-17491482
750,No Good Deed,2014,13200000,53830415,40630415
751,Still Alice,2014,5000000,41797583,36797583
752,"As Above, So Below",2014,5000000,40100000,35100000
753,Foxcatcher,2014,24000000,12096300,-11903700
755,Endless Love,2014,20000000,34077920,14077920
756,The Rover,2014,12250000,2295423,-9954577
757,Think Like a Man Too,2014,24000000,70181428,46181428
758,Suite FranÃ§aise,2014,15000000,9104716,-5895284
762,Annabelle,2014,6500000,255273813,248773813
765,"I, Frankenstein",2014,65000000,71154592,6154592
766,That Awkward Moment,2014,8000000,26049082,18049082
768,Draft Day,2014,27000000,28831145,1831145
769,Brick Mansions,2014,28000000,68896829,40896829
770,The Babadook,2014,2000000,6676471,4676471
771,Tammy,2014,20000000,100525432,80525432
780,Winter's Tale,2014,60000000,30800231,-29199769
783,The Guest,2014,5000000,2367161,-2632839
788,The Water Diviner,2014,22500000,15520023,-6979977
789,The Green Inferno,2014,5000000,6833445,1833445
792,"Alexander and the Terrible, Horrible, No Good, Very Bad Day",2014,28000000,100654149,72654149
793,This Is Where I Leave You,2014,19800000,41296320,21496320
794,The Homesman,2014,16000000,2429989,-13570011
801,Big Game,2014,8500000,7500000,-1000000
803,Jersey Boys,2014,40000000,67347013,27347013
804,About Last Night,2014,12500000,49002684,36502684
805,Million Dollar Arm,2014,25000000,38307627,13307627
806,Wish I Was Here,2014,5500000,5483299,-16701
807,Infinitely Polar Bear,2014,6700000,1430655,-5269345
812,Under the Skin,2014,13300000,5380251,-7919749
813,Veronica Mars,2014,6000000,3485127,-2514873
815,Son of God,2014,22000000,67800064,45800064
819,Justice League: War,2014,3500000,5155325,1655325
820,The Zero Theorem,2014,8500000,770706,-7729294
823,When the Game Stands Tall,2014,15000000,30127963,15127963
839,A Most Wanted Man,2014,15000000,31554855,16554855
842,The Pyramid,2014,6500000,13865435,7365435
844,Clouds of Sils Maria,2014,6600000,1554000,-5046000
845,Kill the Messenger,2014,5000000,2450846,-2549154
854,Locke,2014,2000000,4635300,2635300
856,Dolphin Tale 2,2014,36000000,52424533,16424533
861,The Woman in Black 2: Angel of Death,2014,1000000,26501323,25501323
864,Muppets Most Wanted,2014,50000000,80383113,30383113
870,Tusk,2014,2800000,1826705,-973295
878,5 Flights Up,2014,6000000,1020921,-4979079
881,Heaven is for Real,2014,12000000,101332962,89332962
896,The Legend of Hercules,2014,70000000,61279452,-8720548
901,And So It Goes,2014,30000000,25312387,-4687613
924,Miss Julie,2014,5500000,5000000,-500000
947,Beyond the Lights,2014,7000000,14618727,7618727
954,Moms' Night Out,2014,5000000,10429707,5429707
956,Earth to Echo,2014,13000000,45300000,32300000
976,The Gambler,2014,25000000,39171130,14171130
983,The Grand Seduction,2014,12700000,3430018,-9269982
985,Joe,2014,4000000,2365467,-1634533
1004,Parts Per Billion,2014,500000,15000000,14500000
1023,God's Not Dead,2014,17000000,29789000,12789000
1042,Devil's Due,2014,7000000,36433975,29433975
1069,My Old Lady,2014,5000000,4013786,-986214
1179,Mrs. Brown's Boys D'Movie,2014,5900000,23000000,17100000
1329,Star Wars,1977,11000000,775398007,764398007
1330,The Spy Who Loved Me,1977,14000000,185438673,171438673
1331,The Rescuers,1977,1200000,71215869,70015869
1332,Annie Hall,1977,4000000,38251425,34251425
1334,Close Encounters of the Third Kind,1977,20000000,303788635,283788635
1335,A Bridge Too Far,1977,22000000,50750000,28750000
1338,Sinbad and the Eye of the Tiger,1977,3500000,16000000,12500000
1340,Saturday Night Fever,1977,3500000,237113184,233613184
1341,High Anxiety,1977,3400000,31063038,27663038
1344,The Gauntlet,1977,5500000,26414658,20914658
1351,Exorcist II: The Heretic,1977,14000000,30749142,16749142
1352,Airport '77,1977,6000000,30000000,24000000
1363,Orca: The Killer Whale,1977,6000000,14717854,8717854
1364,Sorcerer,1977,22000000,12000000,-10000000
1365,The Last Wave,1977,810000,1258000,448000
1368,Kingdom of the Spiders,1977,500000,17000000,16500000
1370,Wizards,1977,1200000,9000000,7800000
1386,Avatar,2009,237000000,2781505847,2544505847
1387,Inglourious Basterds,2009,70000000,319131050,249131050
1388,Underworld: Rise of the Lycans,2009,35000000,91327197,56327197
1389,Harry Potter and the Half-Blood Prince,2009,250000000,933959197,683959197
1390,Up,2009,175000000,731342744,556342744
1391,Star Trek,2009,150000000,385680446,235680446
1392,Terminator Salvation,2009,200000000,371353001,171353001
1393,District 9,2009,30000000,210819611,180819611
1394,Sherlock Holmes,2009,90000000,524028679,434028679
1395,(500) Days of Summer,2009,7500000,60722734,53222734
1396,Ice Age: Dawn of the Dinosaurs,2009,90000000,886686817,796686817
1397,The Hangover,2009,35000000,459270619,424270619
1398,Watchmen,2009,130000000,185258983,55258983
1399,2012,2009,200000000,769653595,569653595
1400,9,2009,30000000,48428063,18428063
1401,Angels & Demons,2009,150000000,356613439,206613439
1402,The Princess and the Frog,2009,105000000,267045765,162045765
1403,The Blind Side,2009,29000000,309208309,280208309
1404,Zombieland,2009,23600000,102391382,78791382
1405,The Twilight Saga: New Moon,2009,50000000,709827462,659827462
1406,He's Just Not That Into You,2009,40000000,177259441,137259441
1407,G.I. Joe: The Rise of Cobra,2009,175000000,302469017,127469017
1408,The Proposal,2009,40000000,317375031,277375031
1410,The Ugly Truth,2009,38000000,205298907,167298907
1411,Cloudy with a Chance of Meatballs,2009,100000000,242988466,142988466
1412,Fantastic Mr. Fox,2009,40000000,46471023,6471023
1413,Coraline,2009,60000000,124596398,64596398
1414,Night at the Museum: Battle of the Smithsonian,2009,150000000,413106170,263106170
1415,17 Again,2009,20000000,136267476,116267476
1416,A Christmas Carol,2009,200000000,325233863,125233863
1418,The Lovely Bones,2009,65000000,93525586,28525586
1419,Paul Blart: Mall Cop,2009,26000000,183293131,157293131
1420,Hachi: A Dog's Tale,2009,16000000,47801389,31801389
1421,Law Abiding Citizen,2009,53000000,126690726,73690726
1422,The Box,2009,30000000,33333531,3333531
1423,Crank: High Voltage,2009,20000000,34560577,14560577
1424,Pandorum,2009,33000000,20645327,-12354673
1426,Drag Me to Hell,2009,30000000,90842646,60842646
1428,Knowing,2009,50000000,155446362,105446362
1429,Moon,2009,5000000,9760104,4760104
1430,G-Force,2009,150000000,292817841,142817841
1432,The Taking of Pelham 1 2 3,2009,100000000,150166126,50166126
1433,The Invention of Lying,2009,18500000,31912793,13412793
1434,Confessions of a Shopaholic,2009,40000000,108332743,68332743
1436,Gamer,2009,50000000,40828540,-9171460
1438,Mr. Nobody,2009,47000000,3547209,-43452791
1439,Couples Retreat,2009,70000000,171844840,101844840
1440,Brothers,2009,26000000,43318349,17318349
1441,The Road,2009,32000000,27635305,-4364695
1442,Monsters vs Aliens,2009,175000000,381509870,206509870
1443,Fish Tank,2009,3000000,2357852,-642148
1444,Julie & Julia,2009,40000000,129540499,89540499
1445,Chloe,2009,15000000,8459458,-6540542
1446,Public Enemies,2009,80000000,214104620,134104620
1448,Jennifer's Body,2009,16000000,31556061,15556061
1449,Orphan,2009,20000000,41596251,21596251
1450,All About Steve,2009,15000000,40105542,25105542
1451,The Final Destination,2009,40000000,186167139,146167139
1452,Alvin and the Chipmunks: The Squeakquel,2009,75000000,443140005,368140005
1453,After.Life,2009,4500000,3606395,-893605
1454,Bride Wars,2009,30000000,114663461,84663461
1455,Precious,2009,10000000,63647833,53647833
1456,State of Play,2009,60000000,87784194,27784194
1457,The Unborn,2009,16000000,76514050,60514050
1458,"New York, I Love You",2009,14700000,8049666,-6650334
1459,"I Love You, Man",2009,41000000,91636986,50636986
1460,The Informant!,2009,22000000,35424826,13424826
1461,Race to Witch Mountain,2009,50000000,106303988,56303988
1462,Case 39,2009,27000000,29000000,2000000
1463,The Boat That Rocked,2009,50000000,36348784,-13651216
1465,Daybreakers,2009,20000000,51416464,31416464
1466,The Time Traveler's Wife,2009,39000000,101229792,62229792
1468,Antichrist,2009,11000000,791867,-10208133
1470,Love Happens,2009,18000000,36133014,18133014
1471,Push,2009,38000000,45465299,7465299
1472,Brooklyn's Finest,2009,17000000,29536299,12536299
1473,Saw VI,2009,11000000,68233629,57233629
1474,The Young Victoria,2009,35000000,27409889,-7590111
1475,A Serious Man,2009,7000000,31430334,24430334
1476,A Perfect Getaway,2009,14000000,22852638,8852638
1478,Whiteout,2009,40000000,12206028,-27793972
1481,I Love You Phillip Morris,2009,13000000,10652035,-2347965
1482,Enter the Void,2009,13000000,754249,-12245751
1484,12 Rounds,2009,20000000,17280326,-2719674
1486,3 Idiots,2009,9000000,70000000,61000000
1487,Transformers: Revenge of the Fallen,2009,150000000,836297228,686297228
1488,The Men Who Stare at Goats,2009,24000000,68729358,44729358
1490,Ninja Assassin,2009,40000000,60462347,20462347
1491,Bandslam,2009,20000000,5210988,-14789012
1492,Where the Wild Things Are,2009,100000000,100086793,86793
1493,It's Complicated,2009,85000000,219103655,134103655
1498,Land of the Lost,2009,100000000,68688831,-31311169
1499,Invictus,2009,60000000,122233971,62233971
1500,Planet 51,2009,70000000,104945765,34945765
1506,Year One,2009,60000000,62357900,2357900
1507,Life During Wartime,2009,4500000,744816,-3755184
1508,Ondine,2009,12000000,1644755,-10355245
1510,My Bloody Valentine,2009,15000000,100734718,85734718
1514,Old Dogs,2009,35000000,92219310,57219310
1516,Agora,2009,70000000,39041505,-30958495
1518,The Boondock Saints II: All Saints Day,2009,8000000,10629321,2629321
1519,The Bad Lieutenant: Port of Call - New Orleans,2009,25000000,10589102,-14410898
1520,The Imaginarium of Doctor Parnassus,2009,30000000,61808775,31808775
1521,Horsemen,2009,20000000,1017401,-18982599
1522,Armored,2009,20000000,22942221,2942221
1527,Cirque du Freak: The Vampire's Assistant,2009,40000000,28169671,-11830329
1529,Leaves of Grass,2009,9000000,985117,-8014883
1530,An Education,2009,7500000,26096852,18596852
1531,Funny People,2009,75000000,61458982,-13541018
1533,Up in the Air,2009,25000000,163670000,138670000
1534,Astro Boy,2009,65000000,44091067,-20908933
1535,The International,2009,50000000,60161391,10161391
1538,Universal Soldier: Regeneration,2009,14000000,875386,-13124614
1539,Fast & Furious,2009,85000000,363164265,278164265
1542,Capitalism: A Love Story,2009,20000000,17436509,-2563491
1546,Halloween II,2009,15000000,39421467,24421467
1550,Hannah Montana: The Movie,2009,35000000,155545279,120545279
1552,Banlieue 13 - Ultimatum,2009,15000000,8786375,-6213625
1554,Aliens in the Attic,2009,45000000,57881056,12881056
1558,The Collector,2009,3400000,9444018,6044018
1562,The Fourth Kind,2009,10000000,42333295,32333295
1564,Solitary Man,2009,15000000,5024782,-9975218
1568,The Disappearance of Alice Creed,2009,800000,867714,67714
1569,Duplicity,2009,78146652,60000000,-18146652
1577,Bright Star,2009,8500000,4440055,-4059945
1582,Adventureland,2009,9500000,17164377,7664377
1583,Extract,2009,8000000,10848783,2848783
1588,Nine,2009,80000000,53825515,-26174485
1590,The Messenger,2009,6500000,1521261,-4978739
1593,Away We Go,2009,17000000,14899417,-2100583
1594,My Life in Ruins,2009,17000000,20455276,3455276
1595,My Sister's Keeper,2009,30000000,95714875,65714875
1599,The Soloist,2009,60000000,31720158,-28279842
1601,Friday the 13th,2009,19000000,91379051,72379051
1603,Crossing Over,2009,25000000,1037335,-23962665
1607,Harry Brown,2009,7300000,10329747,3029747
1608,Surrogates,2009,80000000,122444772,42444772
1612,Street Fighter: The Legend of Chun-Li,2009,50000000,12764201,-37235799
1613,Hotel for Dogs,2009,35000000,73034460,38034460
1618,Obsessed,2009,20000000,73830340,53830340
1625,Whip It,2009,15000000,16633035,1633035
1637,Solomon Kane,2009,45000000,7810000,-37190000
1644,X-Men Origins: Wolverine,2009,150000000,341131793,191131793
1648,S. Darko,2009,4000000,4100000,100000
1655,City Island,2009,6000000,6670712,670712
1658,Amelia,2009,40000000,19258519,-20741481
1666,Beyond a Reasonable Doubt,2009,25000000,4388563,-20611437
1674,New in Town,2009,8000000,29010817,21010817
1675,Me and Orson Welles,2009,25000000,2336172,-22663828
1676,Shorts,2009,40000000,28972508,-11027492
1699,Sorority Row,2009,12500000,27206120,14706120
1722,ChÃ©ri,2009,23000000,9366227,-13633773
1724,The Joneses,2009,10000000,7022728,-2977272
1728,Fired Up!,2009,20000000,18599102,-1400898
1736,The Girlfriend Experience,2009,1700000,1007962,-692038
1756,Post Grad,2009,15000000,6405245,-8594755
1758,Paper Heart,2009,1000000,1296971,296971
1774,Crazy Heart,2009,7000000,39462438,32462438
1800,I Hope They Serve Beer in Hell,2009,7000000,1429299,-5570701
1829,Did You Hear About The Morgans?,2009,58000000,85280250,27280250
1831,The Grudge 3,2009,5000000,38610009,33610009
1866,Mao's Last Dancer,2009,25000000,20719451,-4280549
1919,Inception,2010,160000000,825500000,665500000
1920,Iron Man 2,2010,200000000,623933331,423933331
1921,Alice in Wonderland,2010,200000000,1025467110,825467110
1922,Black Swan,2010,13000000,327803731,314803731
1923,Harry Potter and the Deathly Hallows: Part 1,2010,250000000,954305868,704305868
1924,Despicable Me,2010,69000000,543513985,474513985
1925,The Expendables,2010,80000000,274470394,194470394
1926,How to Train Your Dragon,2010,165000000,494878759,329878759
1927,Shutter Island,2010,80000000,294804195,214804195
1928,TRON: Legacy,2010,170000000,400062763,230062763
1929,Tangled,2010,260000000,591794936,331794936
1930,Toy Story 3,2010,200000000,1063171911,863171911
1931,Salt,2010,110000000,293329073,183329073
1932,127 Hours,2010,18000000,35692920,17692920
1933,Easy A,2010,8000000,74952305,66952305
1934,The Chronicles of Narnia: The Voyage of the Dawn Treader,2010,155000000,415686217,260686217
1935,Kick-Ass,2010,28000000,96188903,68188903
1936,The Tourist,2010,100000000,278346189,178346189
1937,Prince of Persia: The Sands of Time,2010,150000000,335154643,185154643
1938,Robin Hood,2010,200000000,310669540,110669540
1939,True Grit,2010,38000000,252276927,214276927
1940,Clash of the Titans,2010,125000000,232713139,107713139
1941,The Sorcerer's Apprentice,2010,150000000,215283742,65283742
1943,The Social Network,2010,40000000,224920315,184920315
1944,Scott Pilgrim vs. the World,2010,60000000,47664559,-12335441
1945,Little Fockers,2010,100000000,310650585,210650585
1946,Predators,2010,40000000,126248813,86248813
1947,Percy Jackson & the Olympians: The Lightning Thief,2010,95000000,226497209,131497209
1948,Unstoppable,2010,100000000,167805466,67805466
1949,Shrek Forever After,2010,165000000,752600867,587600867
1950,Dear John,2010,25000000,114977104,89977104
1951,The A-Team,2010,110000000,177238796,67238796
1952,RED,2010,58000000,71664962,13664962
1953,Machete,2010,20000000,31327899,11327899
1954,Grown Ups,2010,80000000,271430189,191430189
1955,The Book of Eli,2010,80000000,157107755,77107755
1956,Date Night,2010,55000000,152263880,97263880
1957,The Town,2010,37000000,154026136,117026136
1959,The Twilight Saga: Eclipse,2010,68000000,698491347,630491347
1960,Megamind,2010,130000000,321885765,191885765
1961,The Last Airbender,2010,150000000,318502923,168502923
1962,The Other Guys,2010,100000000,170432927,70432927
1964,Insidious,2010,1500000,97009150,95509150
1965,Step Up 3D,2010,30000000,159291809,129291809
1966,The King's Speech,2010,15000000,414211549,399211549
1967,Love & Other Drugs,2010,30000000,102820008,72820008
1968,The Way Back,2010,30000000,20348249,-9651751
1969,Repo Men,2010,32000000,18409891,-13590109
1970,Last Night,2010,7000000,7644937,644937
1971,Knight and Day,2010,117000000,261930431,144930431
1973,Eat Pray Love,2010,60000000,204594016,144594016
1974,Blue Valentine,2010,1000000,12355734,11355734
1975,The Bounty Hunter,2010,40000000,136000000,96000000
1976,Leap Year,2010,19000000,29922472,10922472
1977,Green Zone,2010,100000000,94882889,-5117111
1978,Gulliver's Travels,2010,112000000,237382724,125382724
1979,The Back-Up Plan,2010,35000000,77477008,42477008
1980,Charlie St. Cloud,2010,44000000,48190704,4190704
1981,The Switch,2010,19000000,49830607,30830607
1982,The Runaways,2010,10000000,2995811,-7004189
1983,Valentine's Day,2010,52000000,216485654,164485654
1984,Don't Be Afraid of the Dark,2010,25000000,36993168,11993168
1986,Saw 3D,2010,20000000,136150434,116150434
1987,The Karate Kid,2010,40000000,357852395,317852395
1988,Due Date,2010,65000000,211780824,146780824
1989,Wild Target,2010,8000000,3453043,-4546957
1990,From Paris with Love,2010,52000000,52615806,615806
1991,The Ghost Writer,2010,45000000,60222298,15222298
1992,It's Kind of a Funny Story,2010,8000000,6491240,-1508760
1993,The Next Three Days,2010,30000000,51148651,21148651
1994,A Nightmare on Elm Street,2010,35000000,115664037,80664037
1995,The Losers,2010,25000000,23580000,-1420000
1996,The Fighter,2010,25000000,9190869,-15809131
1997,Get Him to the Greek,2010,40000000,90029656,50029656
1999,Jonah Hex,2010,47000000,10539000,-36461000
2003,Vampires Suck,2010,20000000,80547866,60547866
2004,Inside Job,2010,2000000,7871522,5871522
2005,Killers,2010,75000000,98159963,23159963
2006,Legion,2010,26000000,67918658,41918658
2008,Sex and the City 2,2010,100000000,288347692,188347692
2009,You Again,2010,20000000,32005248,12005248
2010,Nanny McPhee and the Big Bang,2010,35000000,93246388,58246388
2011,Hot Tub Time Machine,2010,36000000,64572262,28572262
2013,Let Me In,2010,20000000,24145613,4145613
2014,Flipped,2010,14000000,1755212,-12244788
2015,Legend of the Guardians: The Owls of Ga'Hoole,2010,80000000,140073390,60073390
2016,Takers,2010,32000000,69055695,37055695
2017,Burlesque,2010,55000000,89519773,34519773
2018,The Company Men,2010,15000000,4882577,-10117423
2019,Going the Distance,2010,32000000,42045846,10045846
2020,Faster,2010,24000000,23081726,-918274
2022,Paranormal Activity 2,2010,3000000,177512032,174512032
2023,Never Let Me Go,2010,15000000,9455232,-5544768
2025,The American,2010,20000000,65464324,45464324
2027,Cop Out,2010,30000000,55583804,25583804
2029,Monsters,2010,500000,4242978,3742978
2031,Life as We Know It,2010,38000000,105610124,67610124
2032,Centurion,2010,12000000,6814789,-5185211
2033,Beginners,2010,3200000,5332926,2132926
2036,Shelter,2010,22000000,851517,-21148483
2037,Stone,2010,22000000,9479718,-12520282
2038,Diary of a Wimpy Kid,2010,15000000,75700498,60700498
2039,I Spit on Your Grave,2010,2000000,572809,-1427191
2040,Piranha 3D,2010,24000000,83188165,59188165
2041,Morning Glory,2010,40000000,58785180,18785180
2042,Conviction,2010,12500000,6732980,-5767020
2043,The Nutcracker: The Untold Story,2010,90000000,16178959,-73821041
2044,The Last Exorcism,2010,1800000,67738090,65938090
2045,Tooth Fairy,2010,48000000,112462508,64462508
2047,Fair Game,2010,22000000,24188922,2188922
2050,Buried,2010,1987650,19152480,17164830
2051,Dinner for Schmucks,2010,69000000,86387857,17387857
2055,The Kids Are All Right,2010,4000000,34705850,30705850
2057,Skyline,2010,10000000,66821036,56821036
2058,The Debt,2010,20000000,45636368,25636368
2062,Winter's Bone,2010,2000000,13831503,11831503
2065,Cats & Dogs 2 : The Revenge of Kitty Galore,2010,85000000,112483764,27483764
2067,MacGruber,2010,10000000,6110000,-3890000
2071,How Do You Know,2010,120000000,48668907,-71331093
2079,The Spy Next Door,2010,28000000,45236543,17236543
2080,She's Out of My League,2010,20000000,49779728,29779728
2085,London Boulevard,2010,25000000,4644108,-20355892
2086,Hereafter,2010,50000000,105197635,55197635
2088,My Soul to Take,2010,25000000,19829957,-5170043
2089,TEKKEN,2010,30000000,967000,-29033000
2091,The Conspirator,2010,25000000,15478800,-9521200
2093,Death at a Funeral,2010,21000000,49050886,28050886
2097,Animal Kingdom,2010,5000000,1000000,-4000000
2098,Marmaduke,2010,50000000,83761844,33761844
2103,Wall Street: Money Never Sleeps,2010,70000000,134748021,64748021
2107,Carlos,2010,18000000,871279,-17128721
2115,Another Year,2010,8000000,18124262,10124262
2117,Everything Must Go,2010,5000000,2614773,-2385227
2119,The Crazies,2010,20000000,54956140,34956140
2123,Rabbit Hole,2010,5000000,5129058,129058
2125,Alpha and Omega,2010,20000000,39300000,19300000
2134,Yogi Bear,2010,80000000,201584141,121584141
2137,StreetDance 3D,2010,5773100,18144030,12370930
2158,Country Strong,2010,15000000,20529194,5529194
2164,"Tomorrow, When the War Began",2010,27000000,16504936,-10495064
2171,Extraordinary Measures,2010,31000000,15134293,-15865707
2173,Devil,2010,10000000,33583175,23583175
2187,Our Family Wedding,2010,14000000,21409028,7409028
2193,Barney's Version,2010,30000000,8454301,-21545699
2196,Edge of Darkness,2010,80000000,74901339,-5098661
2201,4.3.2.1,2010,4600000,1163967,-3436033
2208,Furry Vengeance,2010,35000000,39340177,4340177
2209,Casino Jack,2010,12500000,1083683,-11416317
2220,Dylan Dog: Dead of Night,2010,20000000,4634062,-15365938
2230,The Perfect Game,2010,12500000,3878993,-8621007
2244,The Warrior's Way,2010,425000000,11087569,-413912431
2246,Burke & Hare,2010,10000000,4349187,-5650813
2255,Four Lions,2010,967686,4270000,3302314
2303,Balada triste de trompeta,2010,7000000,3218666,-3781334
2338,Why Did I Get Married Too?,2010,20000000,60072596,40072596
2343,Resident Evil: Afterlife,2010,60000000,296221663,236221663
2359,Vanishing on 7th Street,2010,10000000,1068682,-8931318
2378,Action Replayy,2010,10000000,5000000,-5000000
2387,Secretariat,2010,35000000,60251371,25251371
2409,Fight Club,1999,63000000,100853753,37853753
2410,The Matrix,1999,63000000,463517383,400517383
2411,American Beauty,1999,15000000,356296601,341296601
2412,Star Wars: Episode I - The Phantom Menace,1999,115000000,924317558,809317558
2413,The Mummy,1999,80000000,415885488,335885488
2414,The Green Mile,1999,60000000,284600000,224600000
2415,The Sixth Sense,1999,40000000,672806292,632806292
2416,The World Is Not Enough,1999,135000000,361832400,226832400
2417,Cruel Intentions,1999,10500000,75902208,65402208
2418,Sleepy Hollow,1999,100000000,206071502,106071502
2420,American Pie,1999,11000000,235483004,224483004
2421,Entrapment,1999,66000000,212404396,146404396
2422,Toy Story 2,1999,90000000,485015179,395015179
2423,10 Things I Hate About You,1999,16000000,53478166,37478166
2424,Notting Hill,1999,42000000,363889678,321889678
2425,Austin Powers: The Spy Who Shagged Me,1999,33000000,310940086,277940086
2426,Boys Don't Cry,1999,2000000,11540607,9540607
2427,The Insider,1999,90000000,60289912,-29710088
2428,Galaxy Quest,1999,45000000,90683916,45683916
2429,Eyes Wide Shut,1999,65000000,162091208,97091208
2430,Being John Malkovich,1999,13000000,22863596,9863596
2431,Analyze This,1999,80000000,176885658,96885658
2432,Stuart Little,1999,133000000,300135367,167135367
2433,The Bone Collector,1999,73000000,151493655,78493655
2434,Wild Wild West,1999,170000000,222104681,52104681
2435,The 13th Warrior,1999,160000000,61698899,-98301101
2436,End of Days,1999,100000000,211989043,111989043
2437,The Cider House Rules,1999,24000000,88545092,64545092
2438,The Iron Giant,1999,70000000,23159305,-46840695
2439,Deep Blue Sea,1999,60000000,73648228,13648228
2441,Payback,1999,90000000,161626121,71626121
2442,Runaway Bride,1999,70000000,309457509,239457509
2443,She's All That,1999,10000000,103166989,93166989
2444,Double Jeopardy,1999,70000000,177841558,107841558
2446,Office Space,1999,10000000,12827813,2827813
2447,The Virgin Suicides,1999,6000000,10409377,4409377
2448,Bicentennial Man,1999,100000000,93700000,-6300000
2450,The Ninth Gate,1999,38000000,58401898,20401898
2451,The Hurricane,1999,50000000,73956241,23956241
2452,The Thirteenth Floor,1999,16000000,18564088,2564088
2453,Big Daddy,1999,34200000,234801895,200601895
2455,8MM,1999,40000000,96618699,56618699
2456,Dogma,1999,10000000,30652890,20652890
2459,The Haunting,1999,80000000,91188905,11188905
2460,Forces of Nature,1999,75000000,93888180,18888180
2461,Blast from the Past,1999,35000000,40263020,5263020
2463,Message in a Bottle,1999,80000000,118880016,38880016
2464,The General's Daughter,1999,60000000,149705852,89705852
2465,Stigmata,1999,29000000,50041732,21041732
2466,Stir of Echoes,1999,12000000,21133087,9133087
2469,Magnolia,1999,37000000,48451803,11451803
2470,The Bachelor,1999,51000000,36911617,-14088383
2471,Virus,1999,75000000,14010690,-60989310
2472,The Talented Mr. Ripley,1999,40000000,128798265,88798265
2473,Lake Placid,1999,27000000,56870414,29870414
2474,Detroit Rock City,1999,34000000,4217115,-29782885
2475,Mystery Men,1999,68000000,29762011,-38237989
2477,Fantasia 2000,1999,80000000,90874570,10874570
2478,Go,1999,6500000,28451622,21951622
2479,Never Been Kissed,1999,25000000,84565230,59565230
2482,Three Kings,1999,75000000,108000000,33000000
2483,Man on the Moon,1999,82000000,47434430,-34565570
2484,Brokedown Palace,1999,25000000,13000000,-12000000
2486,House on Haunted Hill,1999,19000000,40846082,21846082
2490,The Thomas Crown Affair,1999,48000000,124305181,76305181
2491,Random Hearts,1999,64000000,74608570,10608570
2492,eXistenZ,1999,15000000,2856712,-12143288
2493,The End of the Affair,1999,23000000,10827816,-12172184
2494,Blue Streak,1999,65000000,117758500,52758500
2495,The Rage: Carrie 2,1999,21000000,17762705,-3237295
2497,Black and White,1999,10000000,5241315,-4758685
2500,The Corruptor,1999,25000000,15156200,-9843800
2504,Universal Soldier: The Return,1999,45000000,10667893,-34332107
2511,Chill Factor,1999,70000000,11263966,-58736034
2513,Life,1999,80000000,73345029,-6654971
2514,Anywhere But Here,1999,23000000,18653615,-4346385
2515,The Astronaut's Wife,1999,75000000,19598588,-55401412
2516,My Favorite Martian,1999,65000000,36850101,-28149899
2518,The Limey,1999,10000000,3193102,-6806898
2520,The Story of Us,1999,50000000,58900031,8900031
2521,Drive Me Crazy,1999,8000000,17843379,9843379
2524,Muppets from Space,1999,24000000,16290976,-7709024
2526,An Ideal Husband,1999,14000000,18535191,4535191
2529,Deuce Bigalow: Male Gigolo,1999,17000000,65535067,48535067
2531,Idle Hands,1999,25000000,4152230,-20847770
2532,Any Given Sunday,1999,55000000,100230832,45230832
2533,The Deep End of the Ocean,1999,38000000,28121100,-9878900
2535,Human Traffic,1999,600000,4000000,3400000
2536,In Too Deep,1999,7000000,14011454,7011454
2538,Teaching Mrs. Tingle,1999,13000000,8946237,-4053763
2550,Drop Dead Gorgeous,1999,10000000,10571408,571408
2553,The Best Man,1999,9000000,34573780,25573780
2554,Simply Irresistible,1999,6000000,4398989,-1601011
2555,Music of the Heart,1999,27000000,14859394,-12140606
2560,"Mystery, Alaska",1999,28000000,8888143,-19111857
2561,The Mod Squad,1999,50000000,13260050,-36739950
2563,The Wood,1999,6000000,25059640,19059640
2565,200 Cigarettes,1999,6000000,6852450,852450
2567,The Out-of-Towners,1999,75000000,29000000,-46000000
2571,Joan of Arc,1999,60000000,66976317,6976317
2576,Beowulf,1999,20000000,1531251,-18468749
2577,Play It to the Bone,1999,24000000,8434146,-15565854
2580,"Happy, Texas",1999,1700000,1943649,243649
2584,Ride with the Devil,1999,38000000,635096,-37364904
2586,Jawbreaker,1999,3000000,3076820,76820
2589,Dick,1999,13000000,27500000,14500000
2591,The King and I,1999,25000000,12000000,-13000000
2596,Outside Providence,1999,7000000,7292175,292175
2611,Baby Geniuses,1999,12000000,36450736,24450736
2617,East Is East,1999,3800000,28200000,24400000
2624,Tea with Mussolini,1999,12000000,21001563,9001563
2633,The Lord of the Rings: The Fellowship of the Ring,2001,93000000,871368364,778368364
2634,Harry Potter and the Philosopher's Stone,2001,125000000,976475550,851475550
2635,Mulholland Drive,2001,15000000,20117339,5117339
2636,Donnie Darko,2001,6000000,1270522,-4729478
2637,"Monsters, Inc.",2001,115000000,562816256,447816256
2638,A.I. Artificial Intelligence,2001,100000000,235926552,135926552
2639,Shrek,2001,60000000,484409218,424409218
2640,Bridget Jones's Diary,2001,25000000,281929795,256929795
2641,Ocean's Eleven,2001,85000000,450717150,365717150
2642,Pearl Harbor,2001,140000000,449220945,309220945
2643,The Mummy Returns,2001,98000000,433013274,335013274
2644,Atlantis: The Lost Empire,2001,120000000,186053725,66053725
2645,Lara Croft: Tomb Raider,2001,115000000,274703340,159703340
2646,A Beautiful Mind,2001,60000000,313542341,253542341
2647,American Pie 2,2001,30000000,287553595,257553595
2648,The Princess Diaries,2001,37000000,165335153,128335153
2649,Moulin Rouge!,2001,52500000,179213434,126713434
2650,Planet of the Apes,2001,100000000,362211740,262211740
2651,The Royal Tenenbaums,2001,21000000,71441250,50441250
2652,Blow,2001,53000000,83282296,30282296
2653,Enemy at the Gates,2001,70000000,96976270,26976270
2654,Black Hawk Down,2001,92000000,172989651,80989651
2655,Legally Blonde,2001,18000000,141774679,123774679
2656,A Knight's Tale,2001,65000000,117487473,52487473
2657,Zoolander,2001,28000000,60780981,32780981
2658,Not Another Teen Movie,2001,16000000,66468332,50468332
2659,Scary Movie 2,2001,45000000,141220678,96220678
2660,Rush Hour 2,2001,90000000,347325802,257325802
2661,Training Day,2001,45000000,104876233,59876233
2662,The Others,2001,17000000,209947037,192947037
2663,Jimmy Neutron: Boy Genius,2001,25000000,80936232,55936232
2664,Jay and Silent Bob Strike Back,2001,22000000,33788161,11788161
2665,Serendipity,2001,28000000,77516304,49516304
2666,Cats & Dogs,2001,60000000,93375151,33375151
2667,Vanilla Sky,2001,68000000,203388341,135388341
2669,Kiss of the Dragon,2001,25000000,64437847,39437847
2670,Spy Game,2001,92000000,143049560,51049560
2671,Swordfish,2001,102000000,147080413,45080413
2672,Shallow Hal,2001,40000000,141069860,101069860
2675,AntiTrust,2001,30000000,17833000,-12167000
2676,Final Fantasy: The Spirits Within,2001,137000000,85131830,-51868170
2678,Original Sin,2001,42000000,35402320,-6597680
2679,Dr. Dolittle 2,2001,70000000,176104344,106104344
2680,Behind Enemy Lines,2001,40000000,91753202,51753202
2681,Jeepers Creepers,2001,10000000,59217789,49217789
2684,From Hell,2001,35000000,74558115,39558115
2685,The Last Castle,2001,72000000,27642707,-44357293
2686,Along Came a Spider,2001,60000000,105178561,45178561
2687,Super Troopers,2001,3000000,18492362,15492362
2688,The Wedding Planner,2001,35000000,94728529,59728529
2689,Rat Race,2001,48000000,85498534,37498534
2690,Gosford Park,2001,19800000,87754044,67954044
2691,Jason X,2001,11000000,16000000,5000000
2692,The Mexican,2001,57000000,147845033,90845033
2693,Joy Ride,2001,23000000,36642838,13642838
2694,I Am Sam,2001,22000000,40270895,18270895
2699,Rock Star,2001,57000000,16991902,-40008098
2701,K-PAX,2001,48000000,50315140,2315140
2704,Don't Say a Word,2001,50000000,100020092,50020092
2706,Crocodile Dundee in Los Angeles,2001,21150000,39438674,18288674
2707,Frailty,2001,11000000,13110448,2110448
2709,Angel Eyes,2001,53000000,29700000,-23300000
2712,Hearts in Atlantis,2001,31000000,24185781,-6814219
2714,The Glass House,2001,30000000,23619609,-6380391
2715,15 Minutes,2001,60000000,56359980,-3640020
2717,Hardball,2001,32000000,40222729,8222729
2718,Evolution,2001,80000000,98376292,18376292
2721,Ali,2001,107000000,87713825,-19286175
2724,The Score,2001,68000000,71069884,3069884
2725,Monster's Ball,2001,4000000,44909486,40909486
2726,Joe Dirt,2001,17700000,30987695,13287695
2728,Exit Wounds,2001,50000000,79958599,29958599
2729,The Tailor of Panama,2001,21000000,28008462,7008462
2730,Sweet November,2001,40000000,65754228,25754228
2731,How High,2001,12000000,31155435,19155435
2733,Tomcats,2001,11000000,23430766,12430766
2735,The Majestic,2001,72000000,37317558,-34682442
2736,3000 Miles to Graceland,2001,62000000,18720175,-43279825
2741,Dil Chahta Hai,2001,2079000,4099000,2020000
2742,Ghosts of Mars,2001,28000000,14010832,-13989168
2743,Saving Silverman,2001,22000000,19351569,-2648431
2745,Riding in Cars with Boys,2001,48000000,35743308,-12256692
2747,Osmosis Jones,2001,75000000,13596911,-61403089
2751,Head Over Heels,2001,14000000,10424470,-3575530
2753,The Fast and the Furious,2001,38000000,207283925,169283925
2754,Human Nature,2001,6000000,705308,-5294692
2755,Save the Last Dance,2001,13000000,91038276,78038276
2760,Spy Kids,2001,35000000,147934180,112934180
2761,The Pledge,2001,35000000,29400000,-5600000
2764,Bandits,2001,75000000,67631903,-7368097
2765,The Animal,2001,22000000,84772742,62772742
2766,Knockaround Guys,2001,15000000,12000000,-3000000
2769,Crazy/Beautiful,2001,13000000,16929123,3929123
2772,Driven,2001,94000000,54744738,-39255262
2773,Out Cold,2001,24000000,14782676,-9217324
2777,American Outlaws,2001,35000000,13678913,-21321087
2778,Hannibal,2001,87000000,351692268,264692268
2779,Domestic Disturbance,2001,75000000,54249294,-20750706
2782,Recess: School's Out,2001,10000000,44460850,34460850
2793,Summer Catch,2001,34000000,19693891,-14306109
2801,Max Keeble's Big Move,2001,12000000,17292381,5292381
2802,Monkeybone,2001,75000000,5409517,-69590483
2810,Corky Romano,2001,11000000,23978402,12978402
2820,Jurassic Park III,2001,93000000,368780809,275780809
2823,Captain Corelli's Mandolin,2001,57000000,62112895,5112895
2832,Kissing Jessica Stein,2001,1000000,10013424,9013424
2836,The Musketeer,2001,40000000,27053815,-12946185
2837,The Cat's Meow,2001,7000000,3646994,-3353006
2840,L.I.E. Long Island Expressway,2001,700000,1667192,967192
2845,Novocaine,2001,6000000,2025238,-3974762
2846,Sugar & Spice,2001,11000000,13276953,2276953
2849,Bones,2001,10000000,7316658,-2683342
2854,The Wash,2001,7000000,10229331,3229331
2856,Made,2001,5000000,5476060,476060
2865,Baby Boy,2001,16000000,29381649,13381649
2875,The Dark Knight,2008,185000000,1001921825,816921825
2876,WALLÂ·E,2008,180000000,521311860,341311860
2877,Iron Man,2008,140000000,585174222,445174222
2878,Taken,2008,25000000,226830568,201830568
2879,Indiana Jones and the Kingdom of the Crystal Skull,2008,185000000,786636033,601636033
2880,Twilight,2008,37000000,392616625,355616625
2881,Quantum of Solace,2008,200000000,586090727,386090727
2882,Kung Fu Panda,2008,130000000,631744560,501744560
2883,Sex Drive,2008,19000000,18755936,-244064
2884,Mamma Mia!,2008,52000000,609841637,557841637
2885,The Curious Case of Benjamin Button,2008,150000000,333932083,183932083
2886,The Mummy: Tomb of the Dragon Emperor,2008,145000000,401128639,256128639
2887,The Incredible Hulk,2008,150000000,163712074,13712074
2888,Gran Torino,2008,33000000,269958228,236958228
2889,Madagascar: Escape 2 Africa,2008,150000000,603900354,453900354
2890,Hellboy II: The Golden Army,2008,85000000,160388063,75388063
2891,Jumper,2008,85000000,222231186,137231186
2892,Journey to the Center of the Earth,2008,45000000,101702060,56702060
2893,Wanted,2008,75000000,258270008,183270008
2895,Slumdog Millionaire,2008,15000000,377910544,362910544
2896,Transporter 3,2008,30000000,108979549,78979549
2897,Valkyrie,2008,75000000,200276000,125276000
2898,"10,000 BC",2008,105000000,266000000,161000000
2899,Hancock,2008,150000000,624029371,474029371
2900,The Hurt Locker,2008,15000000,42000000,27000000
2901,What Happens in Vegas,2008,35000000,170000000,135000000
2902,The Chronicles of Narnia: Prince Caspian,2008,225000000,419651413,194651413
2903,Tropic Thunder,2008,92000000,188072649,96072649
2904,Eagle Eye,2008,80000000,178066569,98066569
2905,The Boy in the Striped Pyjamas,2008,12500000,20416563,7916563
2906,Rambo,2008,50000000,113244290,63244290
2907,Death Race,2008,45000000,73762516,28762516
2908,Step Up 2: The Streets,2008,23000000,150816700,127816700
2909,The Day the Earth Stood Still,2008,80000000,233093859,153093859
2911,Seven Pounds,2008,55000000,168167691,113167691
2912,Cloverfield,2008,25000000,170764026,145764026
2913,Bolt,2008,150000000,309979994,159979994
2914,Forgetting Sarah Marshall,2008,30000000,105173115,75173115
2915,Australia,2008,130000000,49554002,-80445998
2916,Yes Man,2008,70000000,225990978,155990978
2917,Marley & Me,2008,60000000,244082376,184082376
2918,Body of Lies,2008,70000000,113280098,43280098
2919,Burn After Reading,2008,37000000,163720069,126720069
2920,27 Dresses,2008,30000000,160259319,130259319
2921,Inkheart,2008,60000000,57490374,-2509626
2922,21,2008,35000000,69823199,34823199
2923,The Bank Job,2008,20000000,64822796,44822796
2924,Step Brothers,2008,65000000,128107642,63107642
2926,Fool's Gold,2008,70000000,111231041,41231041
2927,Never Back Down,2008,20000000,41627431,21627431
2928,Pineapple Express,2008,27000000,101624843,74624843
2929,The Wrestler,2008,6000000,44703995,38703995
2930,Bedtime Stories,2008,80000000,212874442,132874442
2931,Punisher: War Zone,2008,20500000,10089373,-10410627
2932,Max Payne,2008,35000000,85416905,50416905
2933,Mirrors,2008,35000000,72436439,37436439
2934,Vantage Point,2008,40000000,151161491,111161491
2935,Zack and Miri Make a Porno,2008,24000000,42105111,18105111
2936,Get Smart,2008,80000000,230685453,150685453
2937,Role Models,2008,28000000,92380927,64380927
2942,Babylon A.D.,2008,70000000,72108608,2108608
2944,In Bruges,2008,15000000,32002538,17002538
2945,Changeling,2008,55000000,113020255,58020255
2946,The Spiderwick Chronicles,2008,90000000,162839667,72839667
2947,Harold & Kumar Escape from Guantanamo Bay,2008,12000000,43493123,31493123
2953,Street Kings,2008,20000000,65569869,45569869
2954,Nick and Norah's Infinite Playlist,2008,9000000,32973937,23973937
2955,Four Christmases,2008,80000000,163733697,83733697
2957,Stargate: The Ark of Truth,2008,7000000,8900000,1900000
2958,The House Bunny,2008,25000000,70442940,45442940
2960,Star Wars: The Clone Wars,2008,8500000,68282844,59782844
2961,Saw V,2008,10800000,113857533,103057533
2962,The Love Guru,2008,62000000,41819064,-20180936
2963,Speed Racer,2008,120000000,93945766,-26054234
2964,Vicky Cristina Barcelona,2008,15000000,96408652,81408652
2965,Horton Hears a Who!,2008,85000000,297138014,212138014
2968,The Forbidden Kingdom,2008,55000000,127906624,72906624
2971,Righteous Kill,2008,60000000,73174566,13174566
2972,Transsiberian,2008,15000000,5926410,-9073590
2973,Traitor,2008,22000000,23530831,1530831
2974,You Don't Mess With the Zohan,2008,90000000,201596308,111596308
2975,Defiance,2008,32000000,51155219,19155219
2977,Untraceable,2008,35000000,32483410,-2516590
2980,The Strangers,2008,9000000,82391145,73391145
2982,Milk,2008,20000000,54586584,34586584
2983,Outlander,2008,50000000,7033683,-42966317
2984,The X Files: I Want to Believe,2008,30000000,68369434,38369434
2985,Doubt,2008,20000000,50907234,30907234
2988,City of Ember,2008,55000000,17869048,-37130952
2989,Made of Honor,2008,40000000,84601681,44601681
2992,Deception,2008,25000000,17741298,-7258702
2993,RockNRolla,2008,18000000,25739015,7739015
2994,The Eye,2008,12000000,56309766,44309766
2995,Elegy,2008,13000000,14894347,1894347
2996,Bangkok Dangerous,2008,45000000,42487390,-2512610
2997,Meet the Spartans,2008,30000000,84646831,54646831
2998,Stop-Loss,2008,25000000,11207130,-13792870
3002,Blindness,2008,25000000,19844979,-5155021
3003,The Spirit,2008,60000000,39031337,-20968663
3007,Appaloosa,2008,20000000,20211394,211394
3009,The Happening,2008,60000000,163403799,103403799
3010,Doomsday,2008,30000000,22211426,-7788574
3011,The Secret of Moonacre,2008,12000000,7070330,-4929670
3014,Vals Im Bashir,2008,2000000,11125849,9125849
3017,Sex and the City,2008,65000000,415252786,350252786
3018,The Rocker,2008,15000000,8762890,-6237110
3020,The Tale of Despereaux,2008,60000000,50877145,-9122855
3023,Superhero Movie,2008,35000000,25871834,-9128166
3024,The Secret Life of Bees,2008,11000000,38105395,27105395
3026,The Other Man,2008,15000000,1143856,-13856144
3027,Beverly Hills Chihuahua,2008,20000000,149281606,129281606
3029,Revolutionary Road,2008,35000000,75225693,40225693
3031,Sunshine Cleaning,2008,5000000,16174377,11174377
3042,Ong Bak 2,2008,8500000,8936663,436663
3044,Pride and Glory,2008,30000000,31148328,1148328
3048,Baby Mama,2008,30000000,63833449,33833449
3050,College,2008,7000000,6230276,-769724
3053,Brideshead Revisited,2008,20000000,13204291,-6795709
3056,The Brothers Bloom,2008,20000000,5530764,-14469236
3057,Meet Dave,2008,60000000,50650079,-9349921
3059,Quarantine,2008,12000000,40855419,28855419
3061,Justice League: The New Frontier,2008,3500000,5231128,1731128
3075,Two Lovers,2008,12000000,3148182,-8851818
3076,Passengers,2008,25000000,2000000,-23000000
3077,The Sisterhood of the Traveling Pants 2,2008,27000000,44352417,17352417
3078,The Express,2008,40000000,9793496,-30206504
3080,Surveillance,2008,3500000,1115493,-2384507
3081,The Women,2008,16000000,50007546,34007546
3082,Gong fu guan lan,2008,10000000,22896728,12896728
3085,ÐÐ´Ð¼Ð¸Ñ€Ð°Ð»ÑŠ,2008,2000000,38135878,36135878
3089,Space Chimps,2008,37000000,63800345,26800345
3091,Lakeview Terrace,2008,20000000,27640028,7640028
3110,Jodhaa Akbar,2008,8376800,13000000,4623200
3114,Choke,2008,3000000,3830137,830137
3116,"War, Inc.",2008,5000000,1296184,-3703816
3117,The Wackness,2008,6000000,2899975,-3100025
3118,What Just Happened,2008,25000000,6673422,-18326578
3134,Disaster Movie,2008,25000000,14109284,-10890716
3137,Miracle at St. Anna,2008,45000000,9323833,-35676167
3143,My Best Friend's Girl,2008,20000000,36620508,16620508
3144,Paris,2008,19000000,23550000,4550000
3147,The Midnight Meat Train,2008,15000000,3533227,-11466773
3149,Mutant Chronicles,2008,8000000,2033165,-5966835
3158,Swing Vote,2008,21000000,17600000,-3400000
3176,W.,2008,25100000,29506464,4406464
3180,Fireproof,2008,500000,33456317,32956317
3183,Smart People,2008,7000000,10569964,3569964
3193,Nim's Island,2008,37000000,100076342,63076342
3198,Igor,2008,25000000,30000000,5000000
3206,How to Lose Friends & Alienate People,2008,27000000,17286299,-9713701
3215,Oorlogswinter,2008,4000000,530048,-3469952
3225,Welcome Home Roscoe Jenkins,2008,35000000,43650785,8650785
3235,Ghajini,2008,9100000,76000000,66900000
3243,Jaane Tu... Ya Jaane Na,2008,2300000,11100000,8800000
3257,Bottle Shock,2008,5000000,4040588,-959412
3272,Julia,2008,6000000,1300000,-4700000
3276,Kismat Konnection,2008,4180000,11000000,6820000
3311,It's Alive,2008,11000000,15500000,4500000
3340,Expelled: No Intelligence Allowed,2008,3500000,7700000,4200000
3372,Captain America: The First Avenger,2011,140000000,370569774,230569774
3373,Drive,2011,15000000,76175166,61175166
3374,Harry Potter and the Deathly Hallows: Part 2,2011,125000000,1327817822,1202817822
3375,Pirates of the Caribbean: On Stranger Tides,2011,380000000,1021683000,641683000
3376,Rise of the Planet of the Apes,2011,93000000,482860185,389860185
3377,Thor,2011,150000000,444115007,294115007
3378,In Time,2011,40000000,173930596,133930596
3379,Drive Angry,2011,50000000,28931401,-21068599
3380,The Mechanic,2011,40000000,51070807,11070807
3381,Source Code,2011,32000000,147332697,115332697
3382,Mission: Impossible - Ghost Protocol,2011,145000000,694713380,549713380
3383,"Crazy, Stupid, Love.",2011,50000000,142851197,92851197
3384,The Girl with the Dragon Tattoo,2011,90000000,232617430,142617430
3385,Limitless,2011,27000000,161849455,134849455
3386,Kung Fu Panda 2,2011,150000000,665692281,515692281
3387,Just Go With It,2011,80000000,214918407,134918407
3388,Horrible Bosses,2011,35000000,117000000,82000000
3389,Real Steel,2011,110000000,299268508,189268508
3390,Friends with Benefits,2011,35000000,150483765,115483765
3391,Bad Teacher,2011,20000000,216197492,196197492
3392,Sherlock Holmes: A Game of Shadows,2011,125000000,334615000,209615000
3393,Cars 2,2011,200000000,559852396,359852396
3394,Green Lantern,2011,200000000,219851172,19851172
3395,The Hangover Part II,2011,80000000,254455986,174455986
3396,No Strings Attached,2011,25000000,147780440,122780440
3397,The Adventures of Tintin,2011,130000000,371940071,241940071
3398,Bridesmaids,2011,32500000,288383523,255883523
3399,Hall Pass,2011,36000000,83160734,47160734
3400,Super 8,2011,50000000,260095987,210095987
3401,Sucker Punch,2011,82000000,89792502,7792502
3402,Red Riding Hood,2011,42000000,89162162,47162162
3403,The Twilight Saga: Breaking Dawn - Part 1,2011,110000000,712171856,602171856
3404,Shame,2011,6500000,17693675,11193675
3406,Mr. Popper's Penguins,2011,55000000,187361754,132361754
3407,The Tree of Life,2011,32000000,54674226,22674226
3408,I Am Number Four,2011,50000000,144492830,94492830
3409,Rio,2011,90000000,484635760,394635760
3410,The Artist,2011,15000000,133432856,118432856
3411,Zookeeper,2011,80000000,169852759,89852759
3412,Cowboys & Aliens,2011,163000000,174822325,11822325
3414,War Horse,2011,66000000,177584879,111584879
3415,50/50,2011,8000000,39187783,31187783
3416,Rango,2011,135000000,245724603,110724603
3417,The Change-Up,2011,52000000,75450437,23450437
3418,Hugo,2011,170000000,185770160,15770160
3419,The Lincoln Lawyer,2011,40000000,85412898,45412898
3420,Ghost Rider: Spirit of Vengeance,2011,57000000,149217355,92217355
3421,One Day,2011,15000000,59389433,44389433
3422,Killer Elite,2011,66000000,57777106,-8222894
3423,The Rite,2011,37000000,96047633,59047633
3424,Winnie the Pooh,2011,30000000,14460000,-15540000
3425,The Three Musketeers,2011,75000000,132274484,57274484
3427,Chalet Girl,2011,8000000,1749457,-6250543
3429,Midnight in Paris,2011,30000000,151119219,121119219
3430,Priest,2011,60000000,78309131,18309131
3432,Young Adult,2011,12000000,22939027,10939027
3433,Warrior,2011,25000000,23057115,-1942885
3434,Abduction,2011,35000000,82087155,47087155
3435,Unknown,2011,30000000,130786397,100786397
3436,The Adjustment Bureau,2011,50200000,127869379,77669379
3437,Immortals,2011,75000000,226904017,151904017
3439,Larry Crowne,2011,30000000,36160375,6160375
3440,Paul,2011,40000000,97552050,57552050
3443,Colombiana,2011,40000000,60965854,20965854
3444,Battle: Los Angeles,2011,70000000,202466756,132466756
3445,Final Destination 5,2011,47000000,157887643,110887643
3446,Machine Gun Preacher,2011,30000000,2527904,-27472096
3447,Jack and Jill,2011,79000000,149673788,70673788
3448,What's Your Number?,2011,20000000,30426096,10426096
3449,Season of the Witch,2011,40000000,88100000,48100000
3450,My Week with Marilyn,2011,6400000,35057696,28657696
3452,We Bought a Zoo,2011,50000000,120081841,70081841
3454,The Darkest Hour,2011,30000000,64626786,34626786
3455,The Help,2011,25000000,124272124,99272124
3456,The Grey,2011,25000000,77278331,52278331
3457,Moneyball,2011,50000000,110206216,60206216
3458,We Need to Talk About Kevin,2011,7000000,6038942,-961058
3459,The Roommate,2011,16000000,40492759,24492759
3460,Puss in Boots,2011,130000000,554987477,424987477
3462,The Green Hornet,2011,120000000,227817248,107817248
3463,Something Borrowed,2011,35000000,59901913,24901913
3464,Conan the Barbarian,2011,90000000,48795021,-41204979
3466,Johnny English Reborn,2011,45000000,160078586,115078586
3467,Contagion,2011,60000000,135458097,75458097
3469,The Big Year,2011,41000000,7448385,-33551615
3470,Beastly,2011,17000000,43165571,26165571
3471,A Very Harold & Kumar Christmas,2011,19000000,35387212,16387212
3472,The Thing,2011,35000000,28128670,-6871330
3473,Tower Heist,2011,75000000,152930623,77930623
3474,New Year's Eve,2011,56000000,142044638,86044638
3475,Your Highness,2011,49900000,26121638,-23778362
3480,Apollo 18,2011,5000000,25562924,20562924
3481,Fright Night,2011,17000000,24922237,7922237
3482,Happy Feet Two,2011,130000000,150406466,20406466
3483,Scream 4,2011,40000000,97138686,57138686
3484,Mars Needs Moms,2011,150000000,38992758,-111007242
3485,Attack the Block,2011,14350531,3964682,-10385849
3486,Diary of a Wimpy Kid: Rodrick Rules,2011,21000000,72417394,51417394
3488,Extremely Loud & Incredibly Close,2011,40000000,55247881,15247881
3490,Alvin and the Chipmunks: Chipwrecked,2011,75000000,342695435,267695435
3491,The Beaver,2011,21000000,970816,-20029184
3492,Straw Dogs,2011,25000000,10324441,-14675559
3493,The Best Exotic Marigold Hotel,2011,10000000,136836156,126836156
3494,The Smurfs,2011,110000000,563749323,453749323
3496,Hanna,2011,30000000,63782078,33782078
3499,A Few Best Men,2011,12468389,29007412,16539023
3502,Flypaper,2011,5000000,3142154,-1857846
3503,Margin Call,2011,3500000,19504039,16004039
3504,Gnomeo & Juliet,2011,36000000,189712432,153712432
3505,Blitz,2011,15774948,741875,-15033073
3507,The Descendants,2011,20000000,177243185,157243185
3508,Hop,2011,63000000,183953723,120953723
3509,The Rum Diary,2011,45000000,24000000,-21000000
3511,The Guard,2011,6000000,19560274,13560274
3513,Our Idiot Brother,2011,10000000,17273593,7273593
3514,The Ledge,2011,10000000,610986,-9389014
3515,Footloose,2011,24000000,63543328,39543328
3517,Trespass,2011,36000000,9612469,-26387531
3518,Carnage,2011,25000000,27603069,2603069
3520,The Ides of March,2011,12500000,75993061,63493061
3522,Transformers: Dark of the Moon,2011,195000000,1123746996,928746996
3523,Paranormal Activity 3,2011,5000000,205703818,200703818
3525,The Dilemma,2011,70000000,67112664,-2887336
3526,Take Me Home Tonight,2011,19000000,6928068,-12071932
3530,A Lonely Place to Die,2011,4000000,25345000,21345000
3531,The Muppets,2011,45000000,165184237,120184237
3532,Spy Kids: All the Time in the World,2011,27000000,85564310,58564310
3537,Seeking Justice,2011,17000000,12355798,-4644202
3539,Arthur,2011,40000000,45735397,5735397
3543,The Eagle,2011,25000000,27122040,2122040
3544,The Sitter,2011,25000000,34942188,9942188
3547,W.E.,2011,15000000,868439,-14131561
3557,Coriolanus,2011,7700000,1072602,-6627398
3558,J. Edgar,2011,35000000,84606030,49606030
3559,Sanctum,2011,30000000,108609310,78609310
3561,I Don't Know How She Does It,2011,24000000,30551495,6551495
3562,A Dangerous Method,2011,15000000,27462041,12462041
3563,Soul Surfer,2011,18000000,47088990,29088990
3564,30 Minutes or Less,2011,28000000,40547440,12547440
3566,Hoodwinked Too! Hood VS. Evil,2011,30000000,13521829,-16478171
3576,Water for Elephants,2011,38000000,114156230,76156230
3577,Dream House,2011,50000000,38502340,-11497660
3578,A Better Life,2011,10000000,1759252,-8240748
3583,Rampart,2011,12000000,972512,-11027488
3585,Take Shelter,2011,5000000,3099314,-1900686
3586,Prom,2011,8000000,10130000,2130000
3589,Pina,2011,4317946,14624826,10306880
3595,Courageous,2011,1000000,34522221,33522221
3598,Black Gold,2011,40000000,5446000,-34554000
3601,Killer Joe,2011,10000000,3665069,-6334931
3604,"Big Mommas: Like Father, Like Son",2011,32000000,83615414,51615414
3610,Dolphin Tale,2011,37000000,95404397,58404397
3615,Xin shao lin si,2011,29000000,33662874,4662874
3619,Fast Five,2011,125000000,626137675,501137675
3628,Jumping the Broom,2011,6600000,37710610,31110610
3631,Silent House,2011,2000000,13101672,11101672
3642,Monte Carlo,2011,20000000,17425000,-2575000
3643,Win Win,2011,10831173,10654385,-176788
3654,The Double,2011,17000000,3696232,-13303768
3661,The Iron Lady,2011,13000000,114956699,101956699
3664,Red State,2011,4000000,1104682,-2895318
3666,The Devil's Double,2011,19100000,5728213,-13371787
3680,Shark Night,2011,28000000,10126458,-17873542
3685,Hobo with a Shotgun,2011,3000000,672648,-2327352
3686,Madea's Big Happy Family,2011,25000000,53213633,28213633
3691,Atlas Shrugged Part I,2011,15000000,4627375,-10372625
3698,This Must Be the Place,2011,25000000,11790979,-13209021
3717,Albert Nobbs,2011,8000000,5634828,-2365172
3766,Justin Bieber: Never Say Never,2011,13000000,98441954,85441954
3786,"Jeff, Who Lives at Home",2011,10000000,4417580,-5582420
3801,X-Men: First Class,2011,160000000,344420111,184420111
3832,Glee: The Concert Movie,2011,9000000,18663238,9663238
3911,The Lord of the Rings: The Two Towers,2002,79000000,926287400,847287400
3912,Harry Potter and the Chamber of Secrets,2002,100000000,876688482,776688482
3913,Ice Age,2002,59000000,383257136,324257136
3914,The Bourne Identity,2002,60000000,214034224,154034224
3915,Resident Evil,2002,33000000,102441078,69441078
3916,Spider-Man,2002,139000000,821708551,682708551
3917,Star Wars: Episode II - Attack of the Clones,2002,120000000,649398328,529398328
3918,Catch Me If You Can,2002,52000000,352114312,300114312
3919,Men in Black II,2002,140000000,441818803,301818803
3920,The Pianist,2002,35000000,120072577,85072577
3921,Minority Report,2002,102000000,358372926,256372926
3922,Lilo & Stitch,2002,80000000,145771527,65771527
3923,The Transporter,2002,21000000,43928932,22928932
3924,xXx,2002,70000000,277448382,207448382
3925,Treasure Planet,2002,140000000,109578115,-30421885
3926,Die Another Day,2002,140000000,431971116,291971116
3927,28 Days Later...,2002,5000000,82719885,77719885
3928,Maid in Manhattan,2002,55000000,154906693,99906693
3929,Blade II,2002,54000000,155010032,101010032
3930,Gangs of New York,2002,100000000,193772504,93772504
3931,Panic Room,2002,48000000,196397415,148397415
3932,Stuart Little 2,2002,120000000,169956806,49956806
3933,National Lampoonâ€™s Van Wilder,2002,5000000,38275483,33275483
3934,8 Mile,2002,41000000,215000000,174000000
3935,Mr. Deeds,2002,50000000,171269535,121269535
3936,Bend It Like Beckham,2002,3500159,76578641,73078482
3938,Two Weeks Notice,2002,60000000,93354918,33354918
3939,Signs,2002,72000000,408247917,336247917
3940,The Ring,2002,48000000,249348933,201348933
3942,A Walk to Remember,2002,11000000,41227069,30227069
3943,My Big Fat Greek Wedding,2002,5000000,368744044,363744044
3944,About a Boy,2002,27000000,129000000,102000000
3946,Collateral Damage,2002,85000000,78382433,-6617567
3947,Phone Booth,2002,13000000,97837138,84837138
3948,Star Trek: Nemesis,2002,60000000,67312826,7312826
3949,Equilibrium,2002,20000000,5359645,-14640355
3950,The Good Girl,2002,8000000,16856124,8856124
3951,The Hours,2002,25000000,108846072,83846072
3952,Road to Perdition,2002,80000000,181001478,101001478
3953,Austin Powers in Goldmember,2002,63000000,296633907,233633907
3954,The Santa Clause 2,2002,65000000,172855065,107855065
3955,Insomnia,2002,46000000,113714830,67714830
3956,Ghost Ship,2002,35000000,68349884,33349884
3957,Scooby-Doo,2002,84000000,275650703,191650703
3959,Spirit: Stallion of the Cimarron,2002,80000000,122563539,42563539
3960,D-Tox,2002,55000000,6416302,-48583698
3962,The Scorpion King,2002,60000000,165333180,105333180
3963,I Spy,2002,70000000,33561137,-36438863
3964,Bowling for Columbine,2002,4000000,35564473,31564473
3965,25th Hour,2002,15000000,13060843,-1939157
3970,We Were Soldiers,2002,75000000,114660784,39660784
3971,Jackass: The Movie,2002,5000000,64282312,59282312
3973,Frida,2002,12000000,56298474,44298474
3974,Murder by Numbers,2002,50000000,56714147,6714147
3975,Adaptation.,2002,19000000,32801173,13801173
3976,Sweet Home Alabama,2002,30000000,180622424,150622424
3977,Barbershop,2002,12000000,75781642,63781642
3978,Dark Blue,2002,15000000,9237470,-5762530
3979,The Time Machine,2002,80000000,123729176,43729176
3980,Undisputed,2002,20000000,12398628,-7601372
3981,The Sweetest Thing,2002,43000000,68696770,25696770
3983,Windtalkers,2002,115000000,77628265,-37371735
3984,John Q,2002,36000000,102244770,66244770
3988,Unfaithful,2002,50000000,119137784,69137784
3989,Changing Lanes,2002,45000000,94935764,49935764
3990,Punch-Drunk Love,2002,25000000,17000000,-8000000
3991,K-19: The Widowmaker,2002,100000000,35168966,-64831034
3995,Queen of the Damned,2002,35000000,45479110,10479110
3996,Spy Kids 2: Island of Lost Dreams,2002,38000000,119723358,81723358
3998,Enough,2002,38000000,51801187,13801187
3999,Friday After Next,2002,20000000,33526835,13526835
4000,Return to Never Land,2002,20000000,109862682,89862682
4002,Life or Something Like It,2002,40000000,16872671,-23127329
4003,Slackers,2002,14000000,6413915,-7586085
4006,Chicago,2002,45000000,306776732,261776732
4007,One Hour Photo,2002,12000000,52223306,40223306
4008,Femme Fatale,2002,35000000,16838910,-18161090
4010,City By The Sea,2002,40000000,22433915,-17566085
4013,Reign of Fire,2002,60000000,43061982,-16938018
4014,Showtime,2002,85000000,77741732,-7258268
4016,High Crimes,2002,42000000,63781810,21781810
4017,Moonlight Mile,2002,21000000,10011050,-10988950
4018,Hart's War,2002,70000000,32287044,-37712956
4019,About Schmidt,2002,30000000,105834556,75834556
4020,Blue Crush,2002,25000000,51842679,26842679
4021,Blood Work,2002,50000000,26199517,-23800483
4022,Solaris,2002,47000000,30002758,-16997242
4024,The Four Feathers,2002,35000000,29882645,-5117355
4025,The Quiet American,2002,30000000,27674124,-2325876
4029,The Mothman Prophecies,2002,32000000,55157539,23157539
4032,Far from Heaven,2002,13500000,29027914,15527914
4033,The Rookie,2002,20000000,75597042,55597042
4034,Bad Company,2002,70000000,65977295,-4022705
4036,Confessions of a Dangerous Mind,2002,30000000,33013805,3013805
4042,Ballistic: Ecks vs. Sever,2002,70000000,19924033,-50075967
4044,Trapped,2002,30000000,6916869,-23083131
4048,Clockstoppers,2002,26000000,38793283,12793283
4049,Halloween: Resurrection,2002,13000000,37664855,24664855
4050,Salton Sea,2002,18000000,676698,-17323302
4053,Big Fat Liar,2002,15000000,52970014,37970014
4055,Narc,2002,6500000,12633747,6133747
4062,Brown Sugar,2002,8000000,27362712,19362712
4065,Antwone Fisher,2002,12500000,23367586,10867586
4070,Igby Goes Down,2002,9000000,4777465,-4222535
4072,Swept Away,2002,10000000,598645,-9401355
4074,Boat Trip,2002,20000000,8586376,-11413624
4077,Crossroads,2002,12000000,61141030,49141030
4078,The Adventures of Pluto Nash,2002,100000000,7103973,-92896027
4080,Abandon,2002,25000000,10719357,-14280643
4087,Red Dragon,2002,78000000,209196298,131196298
4089,Serving Sara,2002,29000000,16930185,-12069815
4092,Dragonfly,2002,60000000,52322400,-7677600
4094,Drumline,2002,20000000,57588485,37588485
4113,All About the Benjamins,2002,14000000,25482931,11482931
4115,FearDotCom,2002,40000000,18902015,-21097985
4119,Auto Focus,2002,7000000,2062066,-4937934
4120,The Powerpuff Girls,2002,10000000,11411644,1411644
4123,Possession,2002,25000000,10113733,-14886267
4128,Full Frontal,2002,2000000,2506446,506446
4132,Big Trouble,2002,40000000,8493890,-31506110
4141,Undercover Brother,2002,25000000,41604473,16604473
4177,Pulp Fiction,1994,8000000,213928762,205928762
4178,The Shawshank Redemption,1994,25000000,28341469,3341469
4179,Forrest Gump,1994,55000000,677945399,622945399
4180,The Lion King,1994,45000000,788241776,743241776
4181,Speed,1994,30000000,350448145,320448145
4182,Dumb and Dumber,1994,17000000,247275374,230275374
4183,The Naked Gun 33â…“: The Final Insult,1994,30000000,51132598,21132598
4184,Interview with the Vampire,1994,60000000,223664608,163664608
4186,True Lies,1994,115000000,378882411,263882411
4187,The Mask,1994,23000000,351583407,328583407
4189,Stargate,1994,55000000,196567262,141567262
4190,Clear and Present Danger,1994,62000000,215887717,153887717
4191,Natural Born Killers,1994,34000000,50282766,16282766
4193,Beverly Hills Cop III,1994,50000000,119208989,69208989
4194,The Santa Clause,1994,22000000,189833357,167833357
4195,Legends of the Fall,1994,30000000,160638883,130638883
4197,Four Weddings and a Funeral,1994,6000000,254700832,248700832
4200,The Client,1994,45000000,117615211,72615211
4201,The Crow,1994,15000000,94000000,79000000
4203,The Flintstones,1994,46000000,341631208,295631208
4205,Star Trek: Generations,1994,38000000,120000000,82000000
4206,Ace Ventura: Pet Detective,1994,15000000,107217396,92217396
4209,Disclosure,1994,55000000,214015089,159015089
4210,Junior,1994,60000000,37000000,-23000000
4211,New Nightmare,1994,14000000,18090181,4090181
4212,The Shadow,1994,25000000,48063435,23063435
4213,Heavenly Creatures,1994,5000000,3049135,-1950865
4214,The Swan Princess,1994,35000000,9771658,-25228342
4215,The Pagemaster,1994,27000000,13670688,-13329312
4216,The Next Karate Kid,1994,12000000,15826984,3826984
4219,Color of Night,1994,40000000,19726050,-20273950
4220,Ed Wood,1994,18000000,5887457,-12112543
4221,Timecop,1994,27000000,101646581,74646581
4222,Wyatt Earp,1994,63000000,25052000,-37948000
4227,Terminal Velocity,1994,50000000,16478900,-33521100
4229,Muriel's Wedding,1994,3000000,15119639,12119639
4230,Street Fighter,1994,35000000,99423521,64423521
4231,The Specialist,1994,45000000,170362582,125362582
4233,Thumbelina,1994,28000000,11373501,-16626499
4234,Highlander III: The Sorcerer,1994,26000000,36800000,10800000
4235,On Deadly Ground,1994,50000000,49000000,-1000000
4240,Frankenstein,1994,45000000,112006296,67006296
4241,Renaissance Man,1994,40000000,24332324,-15667676
4242,A Low Down Dirty Shame,1994,10000000,29392418,19392418
4244,PrÃªt-Ã -Porter,1994,15000000,11300653,-3699347
4245,The Chase,1994,26000000,8009329,-17990671
4247,Reality Bites,1994,11500000,20079850,8579850
4274,Hoop Dreams,1994,700000,7830611,7130611
4277,Double Dragon,1994,3500000,2341309,-1158691
4285,The Ref,1994,11000000,11439193,439193
4291,The Air Up There,1994,17080000,21011500,3931500
4303,Don Juan DeMarco,1994,25000000,22200000,-2800000
4309,Leprechaun 2,1994,2000000,2260622,260622
4312,Baby's Day Out,1994,50000000,16671505,-33328495
4315,Surviving the Game,1994,7400000,7690013,290013
4318,Intersection,1994,45000000,21355893,-23644107
4322,Serial Mom,1994,13000000,7820688,-5179312
4352,PCU,1994,9000000,4350774,-4649226
4361,The Avengers,2012,220000000,1519557910,1299557910
4362,Underworld: Awakening,2012,70000000,132400000,62400000
4363,The Dark Knight Rises,2012,250000000,1081041287,831041287
4364,Django Unchained,2012,100000000,425368238,325368238
4365,Skyfall,2012,200000000,1108561013,908561013
4366,The Bourne Legacy,2012,130000000,276572938,146572938
4367,The Hobbit: An Unexpected Journey,2012,250000000,1017003568,767003568
4368,Prometheus,2012,130000000,403170142,273170142
4369,Silver Linings Playbook,2012,21000000,205738714,184738714
4370,The Amazing Spider-Man,2012,215000000,752215857,537215857
4371,Brave,2012,185000000,538983207,353983207
4372,Snow White and the Huntsman,2012,170000000,396600000,226600000
4373,21 Jump Street,2012,42000000,201585328,159585328
4374,Life of Pi,2012,120000000,609016565,489016565
4375,Ice Age: Continental Drift,2012,95000000,877244782,782244782
4376,Ted,2012,50000000,549368315,499368315
4377,Jack Reacher,2012,60000000,218340595,158340595
4378,Lo imposible,2012,42000000,180274123,138274123
4379,Wreck-It Ralph,2012,165000000,471222889,306222889
4380,Pitch Perfect,2012,17000000,115350426,98350426
4381,Men in Black 3,2012,225000000,624026776,399026776
4382,The Hunger Games,2012,75000000,691210692,616210692
4383,Total Recall,2012,125000000,198802074,73802074
4384,Cloud Atlas,2012,102000000,130482868,28482868
4385,The Expendables 2,2012,100000000,312573423,212573423
4386,Taken 2,2012,45000000,376141306,331141306
4387,Dark Shadows,2012,150000000,245527149,95527149
4388,The Perks of Being a Wallflower,2012,13000000,33400000,20400000
4389,Argo,2012,44500000,232324128,187824128
4390,American Reunion,2012,50000000,234989584,184989584
4391,Magic Mike,2012,7000000,167221571,160221571
4392,The Cabin in the Woods,2012,30000000,66486080,36486080
4393,Rise of the Guardians,2012,145000000,306941670,161941670
4394,The Vow,2012,30000000,196114570,166114570
4395,Journey 2: The Mysterious Island,2012,79000000,355692760,276692760
4396,The Paperboy,2012,12500000,1353868,-11146132
4397,Safe,2012,30000000,40346186,10346186
4398,Abraham Lincoln: Vampire Hunter,2012,69000000,112265139,43265139
4399,Upside Down,2012,60000000,8106475,-51893525
4401,The Lorax,2012,70000000,348840316,278840316
4402,Moonrise Kingdom,2012,16000000,68263166,52263166
4404,Dredd,2012,50000000,41037742,-8962258
4405,Battleship,2012,209000000,303025485,94025485
4409,Les MisÃ©rables,2012,61000000,441809770,380809770
4410,Mirror Mirror,2012,85000000,183018522,98018522
4411,John Carter,2012,260000000,284139100,24139100
4412,Looper,2012,30000000,47042000,17042000
4413,The Twilight Saga: Breaking Dawn - Part 2,2012,120000000,829000000,709000000
4414,Zero Dark Thirty,2012,40000000,132820716,92820716
4415,Haywire,2012,23000000,33372606,10372606
4416,Wrath of the Titans,2012,150000000,301000000,151000000
4417,Step Up Revolution,2012,33000000,140470746,107470746
4418,Chronicle,2012,15000000,145000000,130000000
4419,Act of Valor,2012,12000000,81272766,69272766
4420,Hotel Transylvania,2012,85000000,358375603,273375603
4421,Sinister,2012,3000000,77712439,74712439
4423,End of Watch,2012,7000000,48126384,41126384
4425,Lincoln,2012,65000000,275293450,210293450
4426,What to Expect When You're Expecting,2012,40000000,79700000,39700000
4427,The Dictator,2012,65000000,179379533,114379533
4428,Iron Sky,2012,7500000,8135031,635031
4429,The Lucky One,2012,25000000,99357138,74357138
4430,Project X,2012,12000000,100000000,88000000
4431,Contraband,2012,25000000,63100000,38100000
4433,Madagascar 3: Europe's Most Wanted,2012,145000000,746921274,601921274
4435,Lawless,2012,26000000,53676580,27676580
4437,The Raven,2012,26000000,29657751,3657751
4438,Rock of Ages,2012,75000000,59418613,-15581387
4439,Stolen,2012,35000000,2106557,-32893443
4442,The Watch,2012,68000000,68267862,267862
4443,The Pirates! In an Adventure with Scientists!,2012,60000000,118338361,58338361
4444,The Master,2012,32000000,28258060,-3741940
4446,The Five-Year Engagement,2012,30000000,53909751,23909751
4447,This Is 40,2012,35000000,88058786,53058786
4448,Lockout,2012,20000000,32204030,12204030
4449,Wanderlust,2012,35000000,24159934,-10840066
4450,The Woman in Black,2012,17000000,127730736,110730736
4451,Frankenweenie,2012,39000000,81491068,42491068
4452,That's My Boy,2012,70000000,58058367,-11941633
4453,Safe House,2012,85000000,208076205,123076205
4454,Savages,2012,45000000,47000000,2000000
4456,The Sweeney,2012,3730500,6294161,2563661
4458,Flight,2012,31000000,161772375,130772375
4459,Man on a Ledge,2012,42000000,46221189,4221189
4460,Seven Psychopaths,2012,15000000,19422261,4422261
4461,Big Miracle,2012,40000000,24719215,-15280785
4462,Bel Ami,2012,9000000,8303261,-696739
4465,Disconnect,2012,10000000,3428048,-6571952
4466,People Like Us,2012,16000000,12434778,-3565222
4467,Piranha 3DD,2012,5000000,8493728,3493728
4469,The Possession,2012,14000000,85446075,71446075
4470,Silent Hill: Revelation 3D,2012,20000000,52302796,32302796
4471,Killing Them Softly,2012,15000000,37930465,22930465
4472,The Cold Light of Day,2012,20000000,16863583,-3136417
4474,Arbitrage,2012,12000000,35485056,23485056
4475,The Iceman,2012,20000000,1969193,-18030807
4478,Red Dawn,2012,65000000,44806783,-20193217
4479,Red Lights,2012,14000000,13551174,-448826
4480,The Three Stooges,2012,30000000,54819301,24819301
4481,Hope Springs,2012,30000000,114281051,84281051
4484,The Man with the Iron Fists,2012,15000000,15608545,608545
4488,A Thousand Words,2012,40000000,22044277,-17955723
4493,To Rome with Love,2012,17000000,73244881,56244881
4498,Alex Cross,2012,45000000,30353232,-14646768
4499,One for the Money,2012,40000000,36893721,-3106279
4500,Quartet,2012,11000000,59520298,48520298
4501,Lay the Favorite,2012,26350000,1576687,-24773313
4505,ParaNorman,2012,60000000,107139399,47139399
4506,Promised Land,2012,15000000,8138788,-6861212
4507,Diary of a Wimpy Kid: Dog Days,2012,22000000,77112176,55112176
4511,For Greater Glory - The True Story of Cristiada,2012,12000000,9622846,-2377154
4512,Red Tails,2012,58000000,50365377,-7634623
4515,Fun Size,2012,14000000,11417362,-2582638
4517,The Lords of Salem,2012,1500000,1165882,-334118
4519,Premium Rush,2012,35000000,31083599,-3916401
4520,Bachelorette,2012,3000000,11947954,8947954
4522,The Guilt Trip,2012,40000000,41863726,1863726
4524,The Sessions,2012,1000000,9138338,8138338
4526,Seeking a Friend for the End of the World,2012,10000000,9636289,-363711
4530,The Words,2012,6000000,13231461,7231461
4534,Paranormal Activity 4,2012,5000000,142817992,137817992
4536,On the Road,2012,25000000,8784318,-16215682
4538,Universal Soldier: Day of Reckoning,2012,11500000,1402307,-10097693
4550,"For a Good Time, Call...",2012,850000,1243961,393961
4556,Parental Guidance,2012,25000000,119772232,94772232
4560,The Devil Inside,2012,1000000,101758490,100758490
4571,Think Like a Man,2012,12000000,96070507,84070507
4573,Hit & Run,2012,2000000,14400000,12400000
4594,Beasts of the Southern Wild,2012,1800000,21107746,19307746
4603,Fire with Fire,2012,20000000,4636169,-15363831
4604,Safety Not Guaranteed,2012,750000,4007792,3257792
4614,The Apparition,2012,17000000,9627492,-7372508
4624,2 Days in New York,2012,8000000,1653792,-6346208
4628,Robot & Frank,2012,2500000,3325038,825038
4635,Cosmopolis,2012,20500000,6063556,-14436444
4715,Resident Evil: Retribution,2012,65000000,240159255,175159255
4737,Eega,2012,5990000,19450000,13460000
4776,Sparkle,2012,14000000,24637469,10637469
4790,English Vinglish,2012,2840000,11620000,8780000
4810,Not Fade Away,2012,20000000,610792,-19389208
4831,Redd Inc.,2012,500000,1000000,500000
4889,2016: Obama's America,2012,2500000,33400000,30900000
4903,Katy Perry: Part of Me,2012,12000000,32726956,20726956
4949,The Lord of the Rings: The Return of the King,2003,94000000,1118888979,1024888979
4950,Underworld,2003,22000000,95708457,73708457
4951,Pirates of the Caribbean: The Curse of the Black Pearl,2003,140000000,655011224,515011224
4952,Kill Bill: Vol. 1,2003,30000000,180949000,150949000
4953,The Matrix Revolutions,2003,150000000,424988211,274988211
4954,The Matrix Reloaded,2003,150000000,738599701,588599701
4955,Finding Nemo,2003,94000000,864625978,770625978
4956,Bruce Almighty,2003,80000000,484572835,404572835
4957,Love Actually,2003,40000000,244931766,204931766
4958,Elf,2003,32000000,173398518,141398518
4959,Terminator 3: Rise of the Machines,2003,200000000,435000000,235000000
4960,The Dreamers,2003,15000000,15121165,121165
4961,Big Fish,2003,70000000,122919055,52919055
4962,Daredevil,2003,78000000,179179718,101179718
4963,American Wedding,2003,55000000,231449203,176449203
4964,The League of Extraordinary Gentlemen,2003,78000000,179265204,101265204
4965,The Italian Job,2003,60000000,176070171,116070171
4966,The Jungle Book 2,2003,20000000,135680000,115680000
4967,Lost in Translation,2003,4000000,119723856,115723856
4968,Bad Santa,2003,23000000,76488889,53488889
4969,Johnny English,2003,40000000,160583018,120583018
4971,Peter Pan,2003,100000000,121975011,21975011
4972,Scary Movie 3,2003,48000000,220673217,172673217
4973,Honey,2003,18000000,62646763,44646763
4974,A Man Apart,2003,36000000,44350926,8350926
4975,The School of Rock,2003,35000000,131282949,96282949
4976,The Last Samurai,2003,140000000,456758981,316758981
4977,Bad Boys II,2003,130000000,273339556,143339556
4978,Lara Croft Tomb Raider: The Cradle of Life,2003,95000000,156505388,61505388
4979,Wrong Turn,2003,12600000,28650575,16050575
4980,Identity,2003,30000000,90259536,60259536
4981,Master and Commander: The Far Side of the World,2003,150000000,212011111,62011111
4983,Mystic River,2003,25000000,156822020,131822020
4985,Anger Management,2003,75000000,195745823,120745823
4986,The Core,2003,60000000,74208267,14208267
4987,Hulk,2003,137000000,245360480,108360480
4988,Once Upon a Time in Mexico,2003,29000000,98185582,69185582
4990,Old School,2003,24000000,87055349,63055349
4991,How to Lose a Guy in 10 Days,2003,50000000,177371441,127371441
4992,Shanghai Knights,2003,50000000,88323487,38323487
4993,S.W.A.T.,2003,80000000,116643346,36643346
4994,Tears of the Sun,2003,70000000,85632458,15632458
4995,"Legally Blonde 2: Red, White & Blonde",2003,45000000,124914842,79914842
4998,Freaky Friday,2003,26000000,110230332,84230332
4999,Sinbad: Legend of the Seven Seas,2003,60000000,26288320,-33711680
5000,Timeline,2003,80000000,19480739,-60519261
5001,Paycheck,2003,60000000,96269812,36269812
5002,Charlie's Angels: Full Throttle,2003,120000000,259175788,139175788
5003,Something's Gotta Give,2003,80000000,266728738,186728738
5004,The Haunted Mansion,2003,90000000,182290266,92290266
5005,Duplex,2003,40000000,19322135,-20677865
5006,Gothika,2003,40000000,141591324,101591324
5007,21 Grams,2003,20000000,60427839,40427839
5008,Final Destination 2,2003,26000000,90426405,64426405
5010,The Texas Chainsaw Massacre,2003,9500000,107071655,97571655
5012,Cheaper by the Dozen,2003,40000000,190212113,150212113
5013,Cold Mountain,2003,79000000,173013509,94013509
5017,Thirteen,2003,2000000,4601043,2601043
5018,Freddy vs. Jason,2003,30000000,114908830,84908830
5019,Cradle 2 the Grave,2003,25000000,56489558,31489558
5021,Looney Tunes: Back in Action,2003,80000000,68514844,-11485156
5022,Basic,2003,50000000,42792561,-7207439
5023,The Rundown,2003,85000000,80916492,-4083508
5025,2 Fast 2 Furious,2003,76000000,236350661,160350661
5031,Open Range,2003,22000000,68296293,46296293
5032,Just Married,2003,18000000,101564935,83564935
5035,Daddy Day Care,2003,60000000,164433867,104433867
5037,Seabiscuit,2003,87000000,148336445,61336445
5038,Out of Time,2003,50000000,55495563,5495563
5039,Jeepers Creepers 2,2003,17000000,63102666,46102666
5040,The Lizzie McGuire Movie,2003,17000000,55534455,38534455
5041,Dreamcatcher,2003,68000000,75715436,7715436
5045,Spy Kids 3-D: Game Over,2003,38000000,197011982,159011982
5046,Down with Love,2003,35000000,20298207,-14701793
5047,The Order,2003,35000000,11560806,-23439194
5048,Intolerable Cruelty,2003,60000000,119940815,59940815
5049,The Hunted,2003,55000000,34234008,-20765992
5050,House of Sand and Fog,2003,16500000,16942795,442795
5054,Cabin Fever,2003,1500000,30553394,29053394
5055,Runaway Jury,2003,60000000,80154140,20154140
5059,Monster,2003,8000000,60378584,52378584
5062,Bringing Down The House,2003,20000000,132675402,112675402
5064,Gigli,2003,54000000,7266209,-46733791
5065,Gods and Generals,2003,56000000,12923936,-43076064
5068,Dumb and Dumberer: When Harry Met Lloyd,2003,19000000,39267515,20267515
5075,Uptown Girls,2003,20000000,37095657,17095657
5076,Party Monster,2003,5000000,742898,-4257102
5078,The Life of David Gale,2003,50000000,38955598,-11044402
5080,Elephant,2003,3000000,10012022,7012022
5082,House of the Dead,2003,7000000,13818181,6818181
5083,Whale Rider,2003,8000000,41400000,33400000
5087,House of 1000 Corpses,2003,7000000,16829545,9829545
5088,A Guy Thing,2003,20000000,17432163,-2567837
5090,Radio,2003,32000000,52277485,20277485
5091,Young Adam,2003,6400000,2500000,-3900000
5097,Hollywood Homicide,2003,75000000,51142659,-23857341
5098,Swimming Pool,2003,7800000,22441323,14641323
5101,A Mighty Wind,2003,6000000,18750246,12750246
5106,Latter Days,2003,850000,819939,-30061
5107,The Station Agent,2003,500000,8679814,8179814
5109,The Fighting Temptations,2003,15000000,30238577,15238577
5111,Intermission,2003,5000000,4856298,-143702
5128,Calendar Girls,2003,10000000,96542059,86542059
5133,Mambo Italiano,2003,4361898,3031801,-1330097
5135,Agent Cody Banks,2003,28000000,58795814,30795814
5138,Biker Boyz,2003,24000000,23510601,-489399
5142,Ghosts of the Abyss,2003,13000000,17040871,4040871
5148,Stuck on You,2003,55000000,33828318,-21171682
5164,The Company,2003,15000000,2281585,-12718415
5176,Veronica Guerin,2003,17000000,1569918,-15430082
5184,X2,2003,110000000,214948780,104948780
5186,Wonderland,2003,5000000,2466444,-2533556
5195,Alex & Emma,2003,30000000,15368897,-14631103
5196,From Justin to Kelly,2003,12000000,4922166,-7077834
5198,Les Clefs de bagnole,2003,569217,569217,0
5207,Sylvia,2003,7000000,10000000,3000000
5231,Titanic,1997,200000000,1845034188,1645034188
5232,Hercules,1997,85000000,252712101,167712101
5233,Men in Black,1997,90000000,589390539,499390539
5234,Gattaca,1997,36000000,12532777,-23467223
5235,The Fifth Element,1997,90000000,263920180,173920180
5236,Batman & Robin,1997,125000000,238207122,113207122
5238,Tomorrow Never Dies,1997,110000000,333011068,223011068
5239,Good Will Hunting,1997,10000000,225933435,215933435
5240,Jackie Brown,1997,12000000,39673162,27673162
5241,Alien: Resurrection,1997,70000000,162000000,92000000
5242,The Game,1997,50000000,109423648,59423648
5243,Event Horizon,1997,60000000,26673242,-33326758
5244,Anastasia,1997,53000000,139804348,86804348
5245,Home Alone 3,1997,32000000,79082515,47082515
5246,Austin Powers: International Man of Mystery,1997,16500000,67683989,51183989
5247,Starship Troopers,1997,105000000,121214377,16214377
5248,The Full Monty,1997,3500000,257850122,254350122
5249,Con Air,1997,75000000,224012234,149012234
5250,Face/Off,1997,80000000,245676146,165676146
5251,Donnie Brasco,1997,35000000,41954997,6954997
5252,I Know What You Did Last Summer,1997,17000000,125586134,108586134
5253,The Devil's Advocate,1997,57000000,152944660,95944660
5254,Anaconda,1997,45000000,136885767,91885767
5256,Dante's Peak,1997,116000000,178127760,62127760
5257,Speed 2: Cruise Control,1997,160000000,164508066,4508066
5258,L.A. Confidential,1997,35000000,126216940,91216940
5259,Scream 2,1997,24000000,172363301,148363301
5260,Liar Liar,1997,45000000,181000000,136000000
5262,Contact,1997,90000000,171120329,81120329
5263,Lolita,1997,62000000,1060056,-60939944
5264,The Rainmaker,1997,40000000,45916769,5916769
5266,The Jackal,1997,60000000,159330280,99330280
5269,Flubber,1997,80000000,177977226,97977226
5270,The Saint,1997,68000000,118063304,50063304
5271,Conspiracy Theory,1997,75000000,136982834,61982834
5272,Air Force One,1997,85000000,315156409,230156409
5274,Wag the Dog,1997,15000000,64256513,49256513
5275,As Good as It Gets,1997,50000000,314178011,264178011
5276,Breakdown,1997,36000000,50159144,14159144
5277,Seven Years in Tibet,1997,70000000,131457682,61457682
5278,My Best Friend's Wedding,1997,38000000,299288605,261288605
5279,Boogie Nights,1997,15000000,43101594,28101594
5280,Lost Highway,1997,15000000,3675201,-11324799
5281,Mad City,1997,50000000,10541523,-39458477
5285,Bean,1997,18000000,251212670,233212670
5286,The Devil's Own,1997,90000000,140807547,50807547
5290,Kiss the Girls,1997,27000000,60527873,33527873
5291,Absolute Power,1997,50000000,50068310,68310
5292,Vegas Vacation,1997,25000000,36400360,11400360
5293,U Turn,1997,19000000,6682098,-12317902
5295,Mimic,1997,30000000,25480490,-4519510
5296,One Eight Seven,1997,20000000,5716080,-14283920
5298,Spawn,1997,40000000,87840042,47840042
5301,Kundun,1997,28000000,5684789,-22315211
5302,The Postman,1997,80000000,17626234,-62373766
5303,G.I. Jane,1997,50000000,48169156,-1830844
5304,The Relic,1997,60000000,33956608,-26043392
5315,Fire Down Below,1997,60000000,16000000,-44000000
5317,MouseHunt,1997,38000000,122417389,84417389
5318,The Sweet Hereafter,1997,5000000,3263585,-1736415
5322,Cop Land,1997,15000000,44862187,29862187
5324,Selena,1997,20000000,60000000,40000000
5325,Spice World - The Movie,1997,25000000,100000000,75000000
5326,The Ice Storm,1997,18000000,8038061,-9961939
5328,Air Bud,1997,3000000,23144499,20144499
5332,Cats Don't Dance,1997,32000000,3566637,-28433363
5334,Mortal Kombat: Annihilation,1997,30000000,51376861,21376861
5336,Metro,1997,55000000,31987563,-23012437
5340,Wishmaster,1997,5000000,15738769,10738769
5341,For Richer or Poorer,1997,35000000,31611225,-3388775
5343,Turbo: A Power Rangers Movie,1997,10000000,17979739,7979739
5348,The Man Who Knew Too Little,1997,20000000,13801755,-6198245
5349,Turbulence,1997,55000000,11466088,-43533912
5354,Steel,1997,16000000,1686429,-14313571
5358,Private Parts,1997,28000000,41230799,13230799
5362,Playing God,1997,12000000,4000000,-8000000
5364,Picture Perfect,1997,19000000,44332015,25332015
5365,Anna Karenina,1997,35000000,791830,-34208170
5372,Most Wanted,1997,25000000,11838218,-13161782
5380,Midnight in the Garden of Good and Evil,1997,35000000,25105255,-9894745
5386,An American Werewolf in Paris,1997,22000000,26570463,4570463
5387,Amistad,1997,36000000,74000000,38000000
5389,Affliction,1997,6000000,6330054,330054
5390,Rosewood,1997,30000000,13130349,-16869651
5391,The Lost World: Jurassic Park,1997,73000000,229074524,156074524
5392,Switchback,1997,37000000,6482195,-30517805
5402,La vÃ©ritÃ© si je mens !,1997,4000000,29456000,25456000
5415,The Castle,1997,786675,861789,75114
5422,Frozen,2013,150000000,1274219009,1124219009
5423,Gravity,2013,105000000,716392705,611392705
5424,Thor: The Dark World,2013,170000000,479765000,309765000
5425,Iron Man 3,2013,200000000,1215439994,1015439994
5426,Now You See Me,2013,75000000,117698894,42698894
5427,The Hunger Games: Catching Fire,2013,130000000,847423452,717423452
5428,The Wolf of Wall Street,2013,100000000,392000694,292000694
5429,Pacific Rim,2013,180000000,407602906,227602906
5430,Oblivion,2013,120000000,286168572,166168572
5431,The Hobbit: The Desolation of Smaug,2013,250000000,958400000,708400000
5432,Man of Steel,2013,225000000,662845518,437845518
5433,Her,2013,23000000,47351251,24351251
5434,Despicable Me 2,2013,76000000,970761885,894761885
5435,Star Trek Into Darkness,2013,190000000,467365246,277365246
5436,12 Years a Slave,2013,20000000,187000000,167000000
5437,Riddick,2013,38000000,98337295,60337295
5438,The Conjuring,2013,13000000,318000141,305000141
5439,The Great Gatsby,2013,105000000,351040419,246040419
5441,Elysium,2013,115000000,286140700,171140700
5442,A Good Day to Die Hard,2013,92000000,304654182,212654182
5443,The Purge,2013,3000000,89328627,86328627
5444,Monsters University,2013,200000000,743559607,543559607
5445,World War Z,2013,200000000,531865000,331865000
5446,The Secret Life of Walter Mitty,2013,90000000,188133322,98133322
5447,Ender's Game,2013,110000000,125537191,15537191
5448,We're the Millers,2013,37000000,269994119,232994119
5449,2 Guns,2013,61000000,131940411,70940411
5451,Rush,2013,38000000,90247624,52247624
5452,G.I. Joe: Retaliation,2013,130000000,371876278,241876278
5453,Inside Llewyn Davis,2013,11000000,32935319,21935319
5454,Olympus Has Fallen,2013,70000000,161025640,91025640
5455,Percy Jackson: Sea of Monsters,2013,90000000,174578751,84578751
5456,Prisoners,2013,46000000,122126687,76126687
5458,American Hustle,2013,40000000,251171807,211171807
5459,Warm Bodies,2013,35000000,116980662,81980662
5461,Hansel & Gretel: Witch Hunters,2013,50000000,224803475,174803475
5462,47 Ronin,2013,175000000,150962475,-24037525
5464,The Mortal Instruments: City of Bones,2013,60000000,90565421,30565421
5465,Epic,2013,100000000,268426634,168426634
5466,Lone Survivor,2013,40000000,149295601,109295601
5468,Dallas Buyers Club,2013,5000000,55198285,50198285
5469,R.I.P.D.,2013,130000000,61648500,-68351500
5471,Planes,2013,50000000,219788712,169788712
5472,Spring Breakers,2013,5000000,31724284,26724284
5474,The Call,2013,13000000,68572378,55572378
5475,Evil Dead,2013,17000000,97542952,80542952
5476,Last Vegas,2013,28000000,134402450,106402450
5477,The Family,2013,30000000,36894225,6894225
5480,The Place Beyond the Pines,2013,15000000,35485608,20485608
5481,Grown Ups 2,2013,80000000,246984278,166984278
5482,The Hangover Part III,2013,103000000,362000072,259000072
5483,The Croods,2013,135000000,585178928,450178928
5484,Homefront,2013,22000000,43058898,21058898
5485,Escape Plan,2013,50000000,122915111,72915111
5486,Carrie,2013,30000000,82394288,52394288
5487,Captain Phillips,2013,55000000,95000000,40000000
5488,The Counselor,2013,25000000,71009334,46009334
5489,White House Down,2013,150000000,205366737,55366737
5490,Begin Again,2013,8000000,63464861,55464861
5491,The Big Wedding,2013,35000000,21819348,-13180652
5492,Life of Crime,2013,12000000,1456675,-10543325
5494,Jack the Giant Slayer,2013,195000000,197687603,2687603
5495,Runner Runner,2013,30000000,62616646,32616646
5496,Bullet to the Head,2013,55000000,9489829,-45510171
5497,What If,2013,11000000,7847000,-3153000
5498,Delivery Man,2013,26000000,51164106,25164106
5499,This Is the End,2013,32000000,126041322,94041322
5500,Jackass Presents: Bad Grandpa,2013,15000000,151831537,136831537
5501,Parker,2013,35000000,46216641,11216641
5502,After Earth,2013,130000000,243843127,113843127
5504,The Heat,2013,43000000,158674180,115674180
5505,Saving Mr. Banks,2013,35000000,112544580,77544580
5506,Kick-Ass 2,2013,28000000,29000000,1000000
5507,Oculus,2013,5000000,44030246,39030246
5508,The Lone Ranger,2013,255000000,89289910,-165710090
5509,Gangster Squad,2013,60000000,105200903,45200903
5510,Identity Thief,2013,35000000,173965010,138965010
5512,Stoker,2013,12000000,12077441,77441
5514,All Is Lost,2013,9000000,6108720,-2891280
5515,Texas Chainsaw 3D,2013,20000000,47241945,27241945
5516,The Spectacular Now,2013,2500000,6854611,4354611
5517,Trance,2013,20000000,24261569,4261569
5518,Anchorman 2: The Legend Continues,2013,50000000,173649015,123649015
5520,Oz: The Great and Powerful,2013,200000000,491868548,291868548
5521,Turbo,2013,135000000,282570682,147570682
5522,Redemption,2013,20000000,8352885,-11647115
5523,Pain & Gain,2013,25000000,86175291,61175291
5526,The Host,2013,44000000,63327201,19327201
5527,Oldboy,2013,30000000,4861022,-25138978
5528,Labor Day,2013,18000000,20275812,2275812
5529,Mama,2013,15000000,146497771,131497771
5531,The Physician,2013,32000000,57284237,25284237
5532,Admission,2013,13000000,18000000,5000000
5534,The Butler,2013,25000000,115922175,90922175
5535,Movie 43,2013,6000000,32438988,26438988
5536,21 & Over,2013,13000000,48065672,35065672
5537,Escape from Planet Earth,2013,40000000,74597643,34597643
5538,Grudge Match,2013,40000000,44907260,4907260
5539,Belle,2013,10900000,16505460,5605460
5541,Machete Kills,2013,12000000,15008161,3008161
5542,Safe Haven,2013,28000000,97594140,69594140
5545,Bad Words,2013,9500000,7800000,-1700000
5546,The Bling Ring,2013,15000000,19145732,4145732
5547,Empire State,2013,11000000,3639345,-7360655
5548,Behind the Candelabra,2013,23000000,15600000,-7400000
5549,Cloudy with a Chance of Meatballs 2,2013,78000000,248384621,170384621
5551,Blue Jasmine,2013,18000000,97505481,79505481
5552,Third Person,2013,28000000,1021398,-26978602
5556,A Haunted House,2013,2500000,60141683,57641683
5557,Only God Forgives,2013,4800000,10337387,5537387
5558,Side Effects,2013,30000000,63372757,33372757
5561,La migliore offerta,2013,13500000,19255873,5755873
5562,The Incredible Burt Wonderstone,2013,30000000,27437881,-2562119
5563,Mud,2013,10000000,21587700,11587700
5567,The Railway Man,2013,18000000,22309223,4309223
5568,Broken City,2013,56000000,19701164,-36298836
5572,Walking With Dinosaurs,2013,80000000,126546518,46546518
5577,Beautiful Creatures,2013,60000000,60052138,52138
5578,The Frozen Ground,2013,27220000,5496951,-21723049
5579,The Smurfs 2,2013,105000000,347434178,242434178
5580,The Immigrant,2013,16000000,5867686,-10132314
5581,42,2013,40000000,95020213,55020213
5582,Lovelace,2013,10000000,1585582,-8414418
5584,The Way Way Back,2013,4600000,23198652,18598652
5585,The Fifth Estate,2013,28000000,8555008,-19444992
5587,Blood Ties,2013,25500000,2415472,-23084528
5588,The Wolverine,2013,120000000,415440673,295440673
5589,Snitch,2013,35000000,42930462,7930462
5590,Free Birds,2013,55000000,110000000,55000000
5591,Nebraska,2013,12000000,17654912,5654912
5593,Scary Movie 5,2013,20000000,78378744,58378744
5598,Man of Tai Chi,2013,25000000,2054941,-22945059
5599,Baggage Claim,2013,8500000,22456509,13956509
5603,August: Osage County,2013,25000000,74188937,49188937
5615,Before Midnight,2013,3000000,11176469,8176469
5618,Paranormal Activity: The Marked Ones,2013,5000000,86362372,81362372
5624,Jobs,2013,12000000,35931410,23931410
5625,Dark Skies,2013,3500000,25174316,21674316
5626,In a World...,2013,1000000,2963902,1963902
5628,Paranoia,2013,35000000,13785015,-21214985
5636,Repentance,2013,5000000,1189612,-3810388
5644,Out of the Furnace,2013,22000000,15400000,-6600000
5645,The To Do List,2013,1500000,3566225,2066225
5650,Fast & Furious 6,2013,160000000,788679850,628679850
5656,Battle of the Year,2013,20000000,16549477,-3450523
5673,Khumba,2013,20000000,27187375,7187375
5679,Black Nativity,2013,17500000,7018189,-10481811
5713,Phantom,2013,10000000,1034589,-8965411
5722,Wolf Creek 2,2013,8000000,9630444,1630444
5727,Metallica: Through the Never,2013,18000000,7972967,-10027033
5732,Legends of Oz: Dorothy's Return,2013,70000000,18662027,-51337973
5741,Austenland,2013,4900000,2159041,-2740959
5746,The East,2013,6500000,2401510,-4098490
5750,The Best Man Holiday,2013,17000000,71625195,54625195
5772,The Young and Prodigious T.S. Spivet,2013,33000000,9494789,-23505211
5812,Parkland,2013,10000000,653651,-9346349
5833,The Last Exorcism Part II,2013,5000000,15179302,10179302
5837,What Maisie Knew,2013,6000000,1066471,-4933529
5840,Mandela: Long Walk to Freedom,2013,35000000,27330000,-7670000
5846,Philomena,2013,12000000,100129872,88129872
5860,Diana,2013,15000000,21766271,6766271
5875,Gimme Shelter,2013,7500000,1359910,-6140090
5903,Getaway,2013,18000000,10501938,-7498062
5932,Nothing Left to Fear,2013,3000000,1675381,-1324619
6010,Home Run,2013,1200000,2861020,1661020
6041,The Internship,2013,58000000,44000000,-14000000
6065,Ð¡Ñ‚Ð°Ð»Ð¸Ð½Ð³Ñ€Ð°Ð´,2013,30000000,68129518,38129518
6081,Back to the Future,1985,19000000,381109762,362109762
6082,The Breakfast Club,1985,1000000,51525171,50525171
6083,Ladyhawke,1985,20000000,18432000,-1568000
6084,Mad Max Beyond Thunderdome,1985,12305523,36230219,23924696
6085,A View to a Kill,1985,30000000,152427960,122427960
6086,Legend,1985,25000000,15502112,-9497888
6087,The Goonies,1985,19000000,61389680,42389680
6088,A Nightmare on Elm Street Part 2: Freddy's Revenge,1985,3000000,29999213,26999213
6089,Rambo: First Blood Part II,1985,44000000,300400432,256400432
6090,Out of Africa,1985,31000000,128499205,97499205
6091,Rocky IV,1985,31000000,300473716,269473716
6093,The Black Cauldron,1985,25000000,21288692,-3711308
6094,The Color Purple,1985,15000000,146292009,131292009
6095,Commando,1985,10000000,57500000,47500000
6097,The Return of the Living Dead,1985,4000000,14237000,10237000
6098,Witness,1985,12000000,68706993,56706993
6102,Fright Night,1985,9000000,24922237,15922237
6105,Red Sonja,1985,17900000,6948633,-10951367
6106,Day of the Dead,1985,3500000,34000000,30500000
6107,Clue: The Movie,1985,15000000,14643997,-356003
6108,Friday the 13th: A New Beginning,1985,2200000,21930418,19730418
6109,Santa Claus: The Movie,1985,50000000,23717291,-26282709
6116,The Purple Rose of Cairo,1985,15000000,10631333,-4368667
6119,The Jewel of the Nile,1985,25000000,96773200,71773200
6121,Re-Animator,1985,900000,2023414,1123414
6122,Porky's Revenge,1985,9000000,20518905,11518905
6129,After Hours,1985,4500000,10609321,6109321
6130,Pee-wee's Big Adventure,1985,6000000,40940662,34940662
6137,Brewster's Millions,1985,20000000,45833132,25833132
6152,Desperately Seeking Susan,1985,5000000,27400000,22400000
6156,Runaway Train,1985,9000000,7936012,-1063988
6161,Return to Oz,1985,25000000,11137801,-13862199
6165,Mishima: A Life in Four Chapters,1985,5000000,502758,-4497242
6168,Once Bitten,1985,3200000,10000000,6800000
6172,The Last Dragon,1985,10000000,25754284,15754284
6175,Explorers,1985,25000000,9873044,-15126956
6178,Perfect,1985,19000000,12918858,-6081142
6183,My Beautiful Laundrette,1985,860000,2451545,1591545
6185,Missing in Action 2: The Beginning,1985,2410000,10755447,8345447
6190,Harry Potter and the Goblet of Fire,2005,150000000,895921036,745921036
6191,Batman Begins,2005,150000000,374218673,224218673
6192,"The Chronicles of Narnia: The Lion, the Witch and the Wardrobe",2005,180000000,748806957,568806957
6193,V for Vendetta,2005,54000000,132511035,78511035
6194,Sin City,2005,40000000,158733820,118733820
6195,Charlie and the Chocolate Factory,2005,150000000,474968763,324968763
6196,Star Wars: Episode III - Revenge of the Sith,2005,113000000,850000000,737000000
6197,The Hitchhiker's Guide to the Galaxy,2005,50000000,104478416,54478416
6198,The Island,2005,126000000,162949164,36949164
6199,Madagascar,2005,75000000,532680671,457680671
6200,Fantastic Four,2005,100000000,330579719,230579719
6201,Constantine,2005,100000000,230427240,130427240
6202,Wedding Crashers,2005,40000000,285176741,245176741
6203,Ã†on Flux,2005,62000000,52304001,-9695999
6204,The Pacifier,2005,56000000,113006880,57006880
6205,War of the Worlds,2005,132000000,591739379,459739379
6206,Memoirs of a Geisha,2005,85000000,162242962,77242962
6207,The 40 Year Old Virgin,2005,26000000,109449237,83449237
6208,Chicken Little,2005,150000000,314432665,164432665
6209,Hitch,2005,70000000,368100420,298100420
6210,Transporter 2,2005,32000000,85167639,53167639
6212,Nanny McPhee,2005,25000000,122489822,97489822
6213,Kingdom of Heaven,2005,130000000,211643158,81643158
6214,Monster-in-Law,2005,43000000,154749918,111749918
6215,King Kong,2005,207000000,550000000,343000000
6216,Be Cool,2005,53000000,95226116,42226116
6217,Into the Blue,2005,50000000,44434439,-5565561
6218,Pride & Prejudice,2005,28000000,121147947,93147947
6219,Brokeback Mountain,2005,14000000,178043761,164043761
6220,Robots,2005,75000000,260696994,185696994
6222,xXx: State of the Union,2005,87000000,71073932,-15926068
6223,The Sisterhood of the Traveling Pants,2005,25000000,39053061,14053061
6224,Mr. & Mrs. Smith,2005,110000000,478207520,368207520
6226,The Legend of Zorro,2005,75000000,142400065,67400065
6227,Lord of War,2005,42000000,24127895,-17872105
6228,Zathura: A Space Adventure,2005,65000000,64321501,-678499
6229,Elektra,2005,43000000,56681566,13681566
6231,Corpse Bride,2005,40000000,117195061,77195061
6232,The Curse of the Were-Rabbit,2005,30000000,192452832,162452832
6233,Rumor Has It...,2005,70000000,88933562,18933562
6235,The Jacket,2005,29000000,21126225,-7873775
6236,Jarhead,2005,72000000,96889998,24889998
6238,Serenity,2005,39000000,38869464,-130536
6239,Saw II,2005,4000000,152925093,148925093
6240,Just Like Heaven,2005,58000000,102854431,44854431
6241,Herbie Fully Loaded,2005,50000000,66002004,16002004
6242,Elizabethtown,2005,57000000,52034889,-4965111
6244,Four Brothers,2005,45000000,92374674,47374674
6245,Hostel,2005,4800000,80578934,75778934
6246,Kiss Kiss Bang Bang,2005,15000000,15785148,785148
6247,Cinderella Man,2005,88000000,108539911,20539911
6248,Match Point,2005,15000000,85306374,70306374
6249,Hoodwinked!,2005,15000000,51053787,36053787
6250,Hide and Seek,2005,25000000,122644820,97644820
6251,Bewitched,2005,85000000,131426169,46426169
6254,Doom,2005,60000000,55987321,-4012679
6256,Cheaper by the Dozen 2,2005,60000000,129181830,69181830
6257,Fever Pitch,2005,30000000,50451307,20451307
6258,Must Love Dogs,2005,30000000,58405313,28405313
6259,Proof,2005,20000000,7535331,-12464669
6260,The Interpreter,2005,80000000,162944923,82944923
6261,The Brothers Grimm,2005,88000000,105316267,17316267
6262,An Unfinished Life,2005,30000000,18618284,-11381716
6263,Hostage,2005,52000000,77944725,25944725
6264,The Dukes of Hazzard,2005,50000000,110803676,60803676
6265,Munich,2005,70000000,130358911,60358911
6266,The Exorcism of Emily Rose,2005,19000000,144216468,125216468
6267,Thank You for Smoking,2005,6500000,24793509,18293509
6268,Deuce Bigalow: European Gigolo,2005,22000000,22400154,400154
6269,Syriana,2005,50000000,94000000,44000000
6271,Derailed,2005,22000000,57479076,35479076
6272,Oliver Twist,2005,50000000,42093706,-7906294
6273,The Skeleton Key,2005,43000000,91974818,48974818
6275,Racing Stripes,2005,30000000,93772522,63772522
6276,"Good Night, and Good Luck.",2005,7000000,54600000,47600000
6277,Coach Carter,2005,30000000,76669806,46669806
6278,A History of Violence,2005,32000000,60740827,28740827
6279,The Amityville Horror,2005,19000000,108047131,89047131
6280,Fun with Dick and Jane,2005,100000000,202026112,102026112
6281,Unleashed,2005,45000000,50871113,5871113
6282,Rebound,2005,45000000,16809014,-28190986
6283,Guess Who,2005,35000000,68915888,33915888
6285,Two for the Money,2005,35000000,30526509,-4473491
6286,Harsh Times,2005,2000000,5967038,3967038
6287,Flightplan,2005,55000000,223387299,168387299
6288,Assault on Precinct 13,2005,30000000,35294470,5294470
6290,Broken Flowers,2005,10000000,45742101,35742101
6291,The Weather Man,2005,20000000,12482775,-7517225
6293,Wolf Creek,2005,1000000,27762648,26762648
6294,Land of the Dead,2005,15000000,46770602,31770602
6297,Walk the Line,2005,28000000,186438883,158438883
6299,A Lot Like Love,2005,30000000,42886719,12886719
6300,Get Rich or Die Tryin',2005,40000000,46442528,6442528
6301,Kicking & Screaming,2005,45000000,56070433,11070433
6302,MirrorMask,2005,4000000,866999,-3133001
6303,Cursed,2005,35000000,19294901,-15705099
6304,Stay,2005,50000000,8342132,-41657868
6305,Ice Princess,2005,25000000,27645491,2645491
6306,The Longest Yard,2005,82000000,190320568,108320568
6307,Waiting...,2005,3000000,18637690,15637690
6308,Are We There Yet?,2005,32000000,97918663,65918663
6309,A Sound of Thunder,2005,80000000,5989640,-74010360
6312,The Fog,2005,18000000,46201432,28201432
6313,Stealth,2005,135000000,76932943,-58067057
6314,The Wedding Date,2005,15000000,47175038,32175038
6315,BloodRayne,2005,25000000,2405420,-22594580
6320,Sahara,2005,130000000,119269486,-10730514
6321,The Matador,2005,10000000,17297244,7297244
6322,Capote,2005,7000000,49084830,42084830
6323,Valiant,2005,35000000,19478106,-15521894
6324,The Constant Gardener,2005,25000000,82466670,57466670
6326,Hard Candy,2005,950000,7022209,6072209
6327,House of Wax,2005,40000000,68766121,28766121
6328,The Great Raid,2005,80000000,10166502,-69833498
6329,Domino,2005,50000000,22944502,-27055498
6332,Beauty Shop,2005,25000000,36351350,11351350
6335,The Adventures of Sharkboy and Lavagirl,2005,50000000,69425966,19425966
6337,The Greatest Game Ever Played,2005,25000000,15431177,-9568823
6341,The Three Burials of Melquiades Estrada,2005,15000000,12036149,-2963851
6344,Cry_Wolf,2005,1000000,10047674,9047674
6345,Goal!: The Dream Begins,2005,30000000,27610873,-2389127
6346,White Noise,2005,10000000,91196419,81196419
6351,The New World,2005,30000000,30536013,536013
6352,Manderlay,2005,14200000,674918,-13525082
6354,Sky High,2005,35000000,86369815,51369815
6356,Red Eye,2005,26000000,57891803,31891803
6365,Everything is Illuminated,2005,7000000,2697930,-4302070
6369,The Ballad of Jack and Rose,2005,1500000,712294,-787706
6370,"Yours, Mine & Ours",2005,45000000,72028752,27028752
6375,The Producers,2005,45000000,38058335,-6941665
6377,Romanzo criminale,2005,818418,4851244,4032826
6379,Hustle & Flow,2005,8000000,22201636,14201636
6380,Transamerica,2005,1000000,13350369,12350369
6384,Alone in the Dark,2005,20000000,10442808,-9557192
6385,Boogeyman,2005,20000000,67192859,47192859
6386,Les PoupÃ©es Russes,2005,13000000,23727301,10727301
6399,The Cave,2005,30000000,15007991,-14992009
6400,Rent,2005,40000000,31670620,-8329380
6406,The Squid and the Whale,2005,1500000,11098131,9598131
6420,Inside Deep Throat,2005,2000000,653621,-1346379
6424,Tau man ji D,2005,1549000,7096000,5547000
6435,Shopgirl,2005,10284523,11588205,1303682
6437,North Country,2005,35000000,25224242,-9775758
6446,Down in the Valley,2005,8000000,852872,-7147128
6449,Bad News Bears,2005,30000000,34252847,4252847
6464,Because of Winn-Dixie,2005,14000000,32645546,18645546
6467,Lords of Dogtown,2005,25000000,13411957,-11588043
6469,The Proposition,2005,2000000,5048693,3048693
6475,The Lost City,2005,9600000,4386236,-5213764
6480,Dark Water,2005,30000000,25473093,-4526907
6500,Dave Chappelle's Block Party,2005,3000000,11718595,8718595
6502,Bee Season,2005,14000000,6856989,-7143011
6507,Maurice Richard,2005,8000000,2019009,-5980991
6539,Tsotsi,2005,3000000,9879971,6879971
6554,Underworld: Evolution,2006,50000000,111340801,61340801
6555,Pirates of the Caribbean: Dead Man's Chest,2006,200000000,1065659812,865659812
6556,Cars,2006,120000000,461983149,341983149
6557,Casino Royale,2006,150000000,599045960,449045960
6558,The Da Vinci Code,2006,125000000,758239851,633239851
6559,Step Up,2006,12000000,114194847,102194847
6560,Ice Age: The Meltdown,2006,80000000,660940780,580940780
6561,Mission: Impossible III,2006,150000000,397850012,247850012
6562,The Devil Wears Prada,2006,35000000,326551094,291551094
6563,The Departed,2006,90000000,289847354,199847354
6564,The Holiday,2006,85000000,194168700,109168700
6565,The Prestige,2006,40000000,109676311,69676311
6566,Night at the Museum,2006,110000000,574480841,464480841
6567,Babel,2006,25000000,135330182,110330182
6568,Children of Men,2006,76000000,69959751,-6040249
6570,Superman Returns,2006,270000000,391081192,121081192
6571,Borat: Cultural Learnings of America for Make Benefit Glorious Nation of Kazakhstan,2006,18000000,261572744,243572744
6572,Click,2006,82500000,237681299,155181299
6574,The Break-Up,2006,52000000,204999686,152999686
6575,Inside Man,2006,45000000,184376254,139376254
6576,Over the Hedge,2006,80000000,155019340,75019340
6577,Perfume: The Story of a Murderer,2006,50000000,132180323,82180323
6578,Blood Diamond,2006,100000000,170877916,70877916
6580,Crank,2006,12000000,42931041,30931041
6581,Lucky Number Slevin,2006,27000000,56308881,29308881
6582,Eight Below,2006,40000000,120455994,80455994
6583,Final Destination 3,2006,25000000,117719158,92719158
6584,Silent Hill,2006,50000000,97607453,47607453
6585,She's the Man,2006,20000000,33889159,13889159
6586,The Fountain,2006,35000000,15304890,-19695110
6587,Happy Feet,2006,100000000,384335608,284335608
6588,Rocky Balboa,2006,24000000,155721132,131721132
6590,Flushed Away,2006,149000000,64459316,-84540684
6591,The Wild,2006,80000000,37384046,-42615954
6592,DÃ©jÃ  Vu,2006,75000000,180557550,105557550
6593,Eragon,2006,100000000,249288105,149288105
6594,The Lake House,2006,40000000,114830111,74830111
6595,Scary Movie 4,2006,45000000,178262620,133262620
6596,Monster House,2006,75000000,140175006,65175006
6598,Failure to Launch,2006,50000000,88715192,38715192
6599,Apocalypto,2006,40000000,120175290,80175290
6600,The Ant Bully,2006,50000000,55181129,5181129
6601,The Hills Have Eyes,2006,15000000,69623713,54623713
6603,Just My Luck,2006,28000000,38159905,10159905
6604,The Good Shepherd,2006,85000000,59908565,-25091435
6605,Ultraviolet,2006,30000000,31070211,1070211
6607,Miami Vice,2006,135000000,163794509,28794509
6608,John Tucker Must Die,2006,18000000,41009669,23009669
6609,Tristan & Isolde,2006,31000000,28000000,-3000000
6610,Flags of Our Fathers,2006,90000000,65900249,-24099751
6611,Shortbus,2006,2000000,5179037,3179037
6613,Curious George,2006,50000000,69834815,19834815
6614,The Wicker Man,2006,40000000,38755073,-1244927
6615,Smokin' Aces,2006,17000000,57103895,40103895
6617,RV,2006,50000000,87528173,37528173
6619,We Are Marshall,2006,65000000,43545364,-21454636
6620,The Illusionist,2006,40000000,86915017,46915017
6622,Beerfest,2006,17500000,19179969,1679969
6623,The Contract,2006,25000000,5549200,-19450800
6624,All the King's Men,2006,55000000,9450897,-45549103
6626,Big Momma's House 2,2006,40000000,138259062,98259062
6627,Basic Instinct 2,2006,70000000,38629478,-31370522
6628,Clerks II,2006,5000000,26888376,21888376
6629,Talladega Nights: The Ballad of Ricky Bobby,2006,72500000,162966177,90466177
6631,The Pursuit of Happyness,2006,55000000,307077295,252077295
6632,Marie Antoinette,2006,40000000,60474340,20474340
6633,Freedomland,2006,37665000,14655628,-23009372
6637,The Last King of Scotland,2006,6000000,48027970,42027970
6638,Saw III,2006,10000000,163876815,153876815
6640,Nacho Libre,2006,32000000,80197993,48197993
6641,The Black Dahlia,2006,50000000,49111202,-888798
6643,Poseidon,2006,160000000,181674817,21674817
6644,American Dreamz,2006,17000000,7314027,-9685973
6647,Fur: An Imaginary Portrait of Diane Arbus,2006,16800000,2281089,-14518911
6648,"You, Me and Dupree",2006,54000000,130431368,76431368
6649,Little Miss Sunshine,2006,8000000,100523181,92523181
6650,Little Man,2006,64000000,101595121,37595121
6654,Employee of the Month,2006,12000000,38368909,26368909
6655,The Omen,2006,25000000,119188334,94188334
6656,Letters from Iwo Jima,2006,19000000,68673228,49673228
6658,A Scanner Darkly,2006,8500000,5480996,-3019004
6660,Stranger Than Fiction,2006,30000000,53653224,23653224
6661,World Trade Center,2006,63000000,162945894,99945894
6663,A Good Year,2006,35000000,42064105,7064105
6666,Snow Cake,2006,12000000,1381665,-10618335
6667,Itâ€™s a Boy Girl Thing,2006,15500000,7385434,-8114566
6668,Date Movie,2006,20000000,48548426,28548426
6669,Accepted,2006,23000000,38505009,15505009
6671,Open Season,2006,85000000,197309027,112309027
6673,Barnyard,2006,51000000,72779000,21779000
6674,Unknown,2006,3700000,3338228,-361772
6676,Dreamgirls,2006,70000000,154937680,84937680
6677,Snakes on a Plane,2006,33000000,62022014,29022014
6679,Friends with Money,2006,6500000,13368437,6868437
6680,Jackass Number Two,2006,11000000,72778712,61778712
6681,The Guardian,2006,70000000,55011732,-14988268
6684,The Fast and the Furious: Tokyo Drift,2006,85000000,158468292,73468292
6686,Miss Potter,2006,30000000,35078241,5078241
6687,Pulse,2006,38000000,29907685,-8092315
6689,Black Snake Moan,2006,15000000,10903846,-4096154
6690,Goya's Ghosts,2006,50000000,9448082,-40551918
6694,The Hoax,2006,25000000,11772461,-13227539
6695,The Marine,2006,20000000,22165608,2165608
6698,Running with Scissors,2006,12000000,6754898,-5245102
6699,The Shaggy Dog,2006,50000000,61112916,11112916
6700,Stormbreaker,2006,40000000,23937870,-16062130
6701,Madea's Family Reunion,2006,6000000,57231524,51231524
6708,Take the Lead,2006,30000000,34742066,4742066
6709,Zoom,2006,35000000,12506188,-22493812
6714,Aquamarine,2006,12000000,23006849,11006849
6717,Rescue Dawn,2006,10000000,7177143,-2822857
6718,The Wind That Shakes the Barley,2006,6500000,22889018,16389018
6720,16 Blocks,2006,55000000,65664721,10664721
6721,Scoop,2006,4000000,31584901,27584901
6723,Last Holiday,2006,45000000,38399961,-6600039
6725,Notes on a Scandal,2006,15000000,49469904,34469904
6726,United 93,2006,15000000,76286096,61286096
6730,The Queen,2006,15000000,123384128,108384128
6732,The Sentinel,2006,60000000,77920346,17920346
6734,The Good German,2006,32000000,5914908,-26085092
6735,Flyboys,2006,60000000,17800000,-42200000
6738,Running Scared,2006,15000000,9500000,-5500000
6745,Catch and Release,2006,25000000,16158487,-8841513
6746,The Grudge 2,2006,20000000,39143839,19143839
6755,Firewall,2006,45000000,82800000,37800000
6756,Seraphim Falls,2006,18000000,1196307,-16803693
6762,Sherrybaby,2006,2000000,622806,-1377194
6763,Alatriste,2006,24000000,23321954,-678046
6764,Tenacious D in The Pick of Destiny,2006,22000000,13405595,-8594405
6768,Man of the Year,2006,20000000,41237648,21237648
6770,The Covenant,2006,20000000,37597471,17597471
6781,When a Stranger Calls,2006,15000000,66966987,51966987
6782,Infamous,2006,13000000,1151330,-11848670
6783,Another Gay Movie,2006,500000,745327,245327
6786,Dhoom 2,2006,11000000,46396427,35396427
6787,Black Christmas,2006,9000000,21510851,12510851
6788,The Astronaut Farmer,2006,13000000,11130889,-1869111
6795,ATL,2006,20000000,21170563,1170563
6797,Bug,2006,4000000,8059140,4059140
6799,Lady in the Water,2006,75000000,42285169,-32714831
6807,Gridiron Gang,2006,30000000,41480851,11480851
6832,The History Boys,2006,4000000,13401952,9401952
6836,The Namesake,2006,12000000,20138836,8138836
6838,An Inconvenient Truth,2006,1000000,46243000,45243000
6839,Let's Go to Prison,2006,4000000,4630045,630045
6851,This Is England,2006,2380000,8176544,5796544
6857,School for Scoundrels,2006,20000000,17807569,-2192431
6859,Annapolis,2006,26000000,17496992,-8503008
6861,IndigÃ¨nes,2006,14500000,22963701,8463701
6868,Flicka,2006,15000000,21000000,6000000
6871,Stay Alive,2006,9000000,27105095,18105095
6873,The Return,2006,15000000,11992014,-3007986
6883,X-Men: The Last Stand,2006,210000000,234360014,24360014
6890,Who Killed the Electric Car?,2006,1000000,1678874,678874
6896,Akeelah and the Bee,2006,8000000,18948425,10948425
6914,Trailer Park Boys: The Movie,2006,5000000,3833507,-1166493
6925,For Your Consideration,2006,12000000,5542025,-6457975
6962,Harry Potter and the Prisoner of Azkaban,2004,130000000,789804554,659804554
6963,Kill Bill: Vol. 2,2004,30000000,152159461,122159461
6964,Bridget Jones: The Edge of Reason,2004,50000000,40203020,-9796980
6965,Eternal Sunshine of the Spotless Mind,2004,20000000,72258126,52258126
6966,The Notebook,2004,29000000,115603229,86603229
6967,The Incredibles,2004,92000000,631442092,539442092
6968,The Bourne Supremacy,2004,75000000,288500217,213500217
6969,Troy,2004,175000000,497409852,322409852
6970,National Treasure,2004,100000000,347451894,247451894
6971,"I, Robot",2004,120000000,347234916,227234916
6972,50 First Dates,2004,75000000,196482882,121482882
6973,Mean Girls,2004,17000000,129042871,112042871
6974,Van Helsing,2004,160000000,300257475,140257475
6975,Hellboy,2004,66000000,99318987,33318987
6976,The Polar Express,2004,165000000,305875730,140875730
6977,Shrek 2,2004,150000000,919838758,769838758
6978,The Butterfly Effect,2004,13000000,96060858,83060858
6979,Resident Evil: Apocalypse,2004,45000000,129394835,84394835
6980,Ocean's Twelve,2004,110000000,362744280,252744280
6981,Meet the Fockers,2004,80000000,516642939,436642939
6982,The Day After Tomorrow,2004,125000000,544272402,419272402
6983,The Aviator,2004,116000000,102000000,-14000000
6984,Collateral,2004,65000000,217764291,152764291
6985,Shaun of the Dead,2004,4000000,30039392,26039392
6986,Blade: Trinity,2004,65000000,128905366,63905366
6988,The Terminal,2004,60000000,219417255,159417255
6989,Lemony Snicket's A Series of Unfortunate Events,2004,140000000,209073645,69073645
6990,Million Dollar Baby,2004,30000000,216763646,186763646
6991,Garfield,2004,50000000,200804534,150804534
6993,Shark Tale,2004,75000000,367275019,292275019
6994,Sky Captain and the World of Tomorrow,2004,70000000,57958696,-12041304
6996,The SpongeBob SquarePants Movie,2004,30000000,140161792,110161792
6998,Crash,2004,6500000,98410061,91910061
6999,Anchorman: The Legend of Ron Burgundy,2004,26000000,90574188,64574188
7000,13 Going On 30,2004,37000000,96455697,59455697
7001,Ella Enchanted,2004,31000000,27388767,-3611233
7002,The Girl Next Door,2004,25000000,30411183,5411183
7004,Finding Neverland,2004,25000000,116766556,91766556
7005,A Cinderella Story,2004,19000000,70067909,51067909
7006,AVP: Alien vs. Predator,2004,70000000,171183863,101183863
7007,DodgeBall: A True Underdog Story,2004,20000000,167722310,147722310
7008,Banlieue 13,2004,12000000,9584131,-2415869
7009,Alexander,2004,155000000,167298192,12298192
7010,Harold & Kumar Go to White Castle,2004,9000000,23936908,14936908
7011,Saw,2004,1200000,103911669,102711669
7012,Spider-Man 2,2004,200000000,783766341,583766341
7013,EuroTrip,2004,25000000,20796847,-4203153
7014,Man on Fire,2004,70000000,130293714,60293714
7015,Along Came Polly,2004,42000000,171963386,129963386
7016,Closer,2004,27000000,115505027,88505027
7017,The Punisher,2004,33000000,54700105,21700105
7018,Catwoman,2004,100000000,82102379,-17897621
7021,Dawn of the Dead,2004,28000000,102356381,74356381
7023,King Arthur,2004,120000000,203567857,83567857
7024,The Chronicles of Riddick,2004,105000000,115772733,10772733
7025,Spanglish,2004,80000000,55041367,-24958633
7026,Secret Window,2004,40000000,92913171,52913171
7027,Layer Cake,2004,6500000,11850214,5350214
7028,After the Sunset,2004,60000000,61347797,1347797
7029,Thunderbirds,2004,57000000,28283637,-28716363
7030,The Princess Diaries 2: Royal Engagement,2004,40000000,95149435,55149435
7031,The Alamo,2004,145000000,25819961,-119180039
7032,Before Sunset,2004,2700000,15992615,13292615
7033,The Grudge,2004,10000000,183474602,173474602
7034,Cellular,2004,25000000,56422687,31422687
7035,The Manchurian Candidate,2004,80000000,96105964,16105964
7036,The Machinist,2004,5000000,8203235,3203235
7037,Seed of Chucky,2004,12000000,24829644,12829644
7038,Taxi,2004,25000000,36609966,11609966
7039,Alfie,2004,60000000,13395939,-46604061
7041,Shall We Dance?,2004,50000000,170128460,120128460
7042,Jersey Girl,2004,35000000,36098382,1098382
7043,The Stepford Wives,2004,90000000,102000000,12000000
7045,ã‚¢ãƒƒãƒ—ãƒ«ã‚·ãƒ¼ãƒ‰,2004,10000000,1461989,-8538011
7046,Home on the Range,2004,110000000,103951461,-6048539
7047,Hidalgo,2004,100000000,108103450,8103450
7049,Fahrenheit 9/11,2004,6000000,119114517,113114517
7050,Win a Date with Tad Hamilton!,2004,17000000,16980098,-19902
7051,White Chicks,2004,37000000,113086475,76086475
7052,Hotel Rwanda,2004,17500000,38000000,20500000
7054,Walking Tall,2004,56000000,57223890,1223890
7055,Twisted,2004,50000000,25195000,-24805000
7059,Team America: World Police,2004,32000000,50907422,18907422
7065,Sideways,2004,16000000,109502303,93502303
7066,Without a Paddle,2004,19000000,69631118,50631118
7068,Starsky & Hutch,2004,60000000,170268750,110268750
7070,Confessions of a Teenage Drama Queen,2004,15000000,29331068,14331068
7071,The Village,2004,60000000,256697520,196697520
7072,The Whole Ten Yards,2004,40000000,26155781,-13844219
7073,The Passion of the Christ,2004,30000000,611899420,581899420
7074,Anacondas: The Hunt for the Blood Orchid,2004,20000000,70992898,50992898
7075,Ray,2004,40000000,124731534,84731534
7076,Dirty Dancing: Havana Nights,2004,25000000,27685016,2685016
7080,Wimbledon,2004,31000000,41512007,10512007
7081,Taking Lives,2004,45000000,65470529,20470529
7084,The Phantom of the Opera,2004,70000000,154648887,84648887
7086,Garden State,2004,2500000,26781723,24281723
7089,Exorcist: The Beginning,2004,80000000,78000586,-1999414
7091,Wicker Park,2004,30000000,13001257,-16998743
7093,The Life Aquatic with Steve Zissou,2004,50000000,34808403,-15191597
7094,Around the World in 80 Days,2004,110000000,72178895,-37821105
7095,Barbershop 2:  Back in Business,2004,18000000,65070412,47070412
7102,The Forgotten,2004,42000000,117575636,75575636
7103,Surviving Christmas,2004,45000000,14793624,-30206376
7114,Flight of the Phoenix,2004,45000000,21009180,-23990820
7116,Godsend,2004,25000000,30114487,5114487
7119,Friday Night Lights,2004,30000000,61255921,31255921
7122,Raising Helen,2004,50000000,49718611,-281389
7126,Paparazzi,2004,20000000,16605763,-3394237
7129,Raise Your Voice,2004,15000000,14867514,-132486
7132,Vanity Fair,2004,23000000,16123851,-6876149
7135,Deux frÃ¨res,2004,74500000,62172050,-12327950
7142,Torque,2004,40000000,46546197,6546197
7143,Miracle,2004,28000000,64445708,36445708
7145,Mindhunters,2004,27000000,21148829,-5851171
7152,Soul Plane,2004,16000000,14822346,-1177654
7155,Club Dread,2004,8500000,5001655,-3498345
7159,Suspect Zero,2004,27000000,13000000,-14000000
7161,The Big Bounce,2004,50000000,6808550,-43191450
7167,Mr. 3000,2004,30000000,21800302,-8199698
7169,Connie and Carla,2004,20000000,11341016,-8658984
7172,Spartan,2004,19250000,8112712,-11137288
7173,Agent Cody Banks 2: Destination London,2004,26000000,28818995,2818995
7174,Johnson Family Vacation,2004,12000000,31179516,19179516
7179,A Home at the End of the World,2004,6500000,1548955,-4951045
7180,Little Black Book,2004,35000000,22034832,-12965168
7183,Against the Ropes,2004,39000000,6614280,-32385720
7192,A Dirty Shame,2004,15000000,1914166,-13085834
7197,Ladder 49,2004,60000000,74541707,14541707
7205,Catch That Kid,2004,18000000,16702864,-1297136
7206,Il cartaio,2004,2600000,1479042,-1120958
7221,Riding Giants,2004,2600000,3166000,566000
7225,Mean Creek,2004,500000,603943,103943
7228,We Don't Live Here Anymore,2004,3000000,2037545,-962455
7234,Welcome to Mooseport,2004,30000000,14000000,-16000000
7244,Never Die Alone,2004,3000000,5923000,2923000
7250,Narco,2004,823258,823258,0
7269,The Godfather,1972,6000000,245066411,239066411
7270,Deliverance,1972,2000000,46122355,44122355
7271,Conquest of the Planet of the Apes,1972,1800000,9700000,7900000
7273,Frenzy,1972,3500000,12600000,9100000
7278,Everything You Always Wanted to Know About Sex *But Were Afraid to Ask,1972,2000000,18016290,16016290
7284,The Poseidon Adventure,1972,5000000,84563118,79563118
7288,The Getaway,1972,3352254,58831997,55479743
7309,The Empire Strikes Back,1980,18000000,538400000,520400000
7310,The Shining,1980,19000000,44017374,25017374
7311,Airplane!,1980,3500000,83453539,79953539
7312,The Blues Brothers,1980,27000000,115229890,88229890
7313,The Blue Lagoon,1980,4500000,58853106,54353106
7314,Raging Bull,1980,18000000,23000000,5000000
7315,Superman II,1980,54000000,108185706,54185706
7316,Friday the 13th,1980,550000,59754601,59204601
7318,Flash Gordon,1980,35000000,27107960,-7892040
7319,The Elephant Man,1980,5000000,26010864,21010864
7324,The Fog,1980,1000000,21378361,20378361
7326,Caddyshack,1980,6000000,39846344,33846344
7327,Dressed to Kill,1980,6500000,31899000,25399000
7328,Used Cars,1980,8000000,11715321,3715321
7332,Heaven's Gate,1980,44000000,3484331,-40515669
7343,Altered States,1980,15000000,19853892,4853892
7348,American Gigolo,1980,4800000,22743674,17943674
7352,Atlantic City,1980,7200000,12729678,5529678
7355,Stardust Memories,1980,10000000,10389003,389003
7361,Prom Night,1980,1000000,14796236,13796236
7367,Battle Beyond the Stars,1980,2000000,11000000,9000000
7370,Xanadu,1980,20000000,22471595,2471595
7371,The Long Riders,1980,10000000,15795189,5795189
7387,Pirates of the Caribbean: At World's End,2007,300000000,961000000,661000000
7388,Harry Potter and the Order of the Phoenix,2007,150000000,938212738,788212738
7389,Ratatouille,2007,150000000,623722818,473722818
7390,The Bourne Ultimatum,2007,70000000,442824138,372824138
7391,No Country for Old Men,2007,25000000,171600000,146600000
7392,I Am Legend,2007,150000000,585349010,435349010
7393,National Treasure: Book of Secrets,2007,130000000,457363168,327363168
7394,Spider-Man 3,2007,258000000,890871626,632871626
7395,The Mist,2007,18000000,57096190,39096190
7396,Stardust,2007,70000000,135560026,65560026
7397,Death Proof,2007,25000000,25037897,37897
7398,Live Free or Die Hard,2007,110000000,383531464,273531464
7399,Rush Hour 3,2007,140000000,258022233,118022233
7400,Into the Wild,2007,15000000,56255142,41255142
7401,300,2007,65000000,422610419,357610419
7402,Ghost Rider,2007,110000000,228738393,118738393
7403,Juno,2007,7500000,231411584,223911584
7404,Bridge to Terabithia,2007,60000000,137587063,77587063
7405,Shooter,2007,61000000,95696996,34696996
7406,Atonement,2007,30000000,129266061,99266061
7407,There Will Be Blood,2007,25000000,76181545,51181545
7409,American Gangster,2007,100000000,266465037,166465037
7411,Shrek the Third,2007,160000000,798958165,638958165
7412,Sweeney Todd: The Demon Barber of Fleet Street,2007,50000000,152000000,102000000
7413,Superbad,2007,20000000,169860655,149860655
7414,Alvin and the Chipmunks,2007,60000000,361366633,301366633
7415,Bee Movie,2007,150000000,287594577,137594577
7416,Meet the Robinsons,2007,150000000,169332978,19332978
7417,P.S. I Love You,2007,30000000,156835339,126835339
7418,Knocked Up,2007,30000000,219076518,189076518
7419,The Number 23,2007,30000000,77566815,47566815
7421,4: Rise of the Silver Surfer,2007,130000000,289047763,159047763
7422,Enchanted,2007,85000000,340487652,255487652
7423,Zodiac,2007,65000000,84785914,19785914
7425,Ocean's Thirteen,2007,85000000,311312624,226312624
7426,TMNT,2007,34000000,95608995,61608995
7427,The Simpsons Movie,2007,75000000,527068851,452068851
7428,Charlie Wilson's War,2007,75000000,119000410,44000410
7429,28 Weeks Later,2007,15000000,64238440,49238440
7430,The Kingdom,2007,70000000,86658558,16658558
7431,Aliens vs Predator: Requiem,2007,40000000,41797066,1797066
7432,Sunshine,2007,50000000,32017803,-17982197
7433,Mr. Bean's Holiday,2007,25000000,229736344,204736344
7434,Mr. Brooks,2007,20000000,41637263,21637263
7435,30 Days of Night,2007,30000000,75505973,45505973
7436,The Golden Compass,2007,180000000,372234864,192234864
7439,88 Minutes,2007,30000000,16930884,-13069116
7440,The Brave One,2007,70000000,69766619,-233381
7441,Disturbia,2007,20000000,117760134,97760134
7442,Lions for Lambs,2007,35000000,63215872,28215872
7443,3:10 to Yuma,2007,55000000,70016220,15016220
7444,August Rush,2007,25000000,66122026,41122026
7445,Awake,2007,86000000,14373825,-71626175
7446,War,2007,25000000,40452643,15452643
7448,Evan Almighty,2007,175000000,173000000,-2000000
7449,I Now Pronounce You Chuck & Larry,2007,85000000,186072214,101072214
7450,Next,2007,70000000,18211013,-51788987
7452,Premonition,2007,20000000,84146832,64146832
7454,Saw IV,2007,10000000,139352633,129352633
7455,Fred Claus,2007,100000000,97838349,-2161651
7457,Hairspray,2007,50000000,90450008,40450008
7460,Shoot 'Em Up,2007,39000000,26820641,-12179359
7461,Eastern Promises,2007,51500000,55112356,3612356
7462,Beowulf,2007,70000000,195735876,125735876
7463,No Reservations,2007,28000000,92601050,64601050
7465,The Heartbreak Kid,2007,60000000,127766650,67766650
7466,Surf's Up,2007,85000000,149044513,64044513
7467,1408,2007,25000000,94679598,69679598
7468,Hitman,2007,24000000,99965753,75965753
7469,The Game Plan,2007,22000000,147880543,125880543
7471,Grindhouse,2007,67000000,25037897,-41962103
7472,Run Fatboy Run,2007,10000000,33000000,23000000
7473,The Messengers,2007,16000000,1109660,-14890340
7474,Transformers,2007,150000000,709709780,559709780
7475,The Bucket List,2007,45000000,175372502,130372502
7476,Hostel: Part II,2007,10200000,35619521,25419521
7479,The Hitcher,2007,10000000,25399945,15399945
7482,I Know Who Killed Me,2007,12000000,9620399,-2379601
7483,Halloween,2007,15000000,80253908,65253908
7484,Becoming Jane,2007,16500000,37311672,20811672
7486,Funny Games,2007,15000000,7938872,-7061128
7488,Elizabeth: The Golden Age,2007,25000000,74237563,49237563
7491,The Invasion,2007,80000000,15071514,-64928486
7494,Before the Devil Knows You're Dead,2007,18000000,25005257,7005257
7496,Daddy Day Camp,2007,6000000,18197398,12197398
7498,Waitress,2007,2000000,22179430,20179430
7501,P2,2007,8000000,7766240,-233760
7502,Resident Evil: Extinction,2007,45000000,147717833,102717833
7503,Diary of the Dead,2007,2000000,5364858,3364858
7504,The Assassination of Jesse James by the Coward Robert Ford,2007,30000000,14711793,-15288207
7505,A Mighty Heart,2007,16000000,18928871,2928871
7507,The Reaping,2007,40000000,62771059,22771059
7509,Perfect Stranger,2007,60795000,73090611,12295611
7510,KatyÅ„,2007,5200000,14723313,9523313
7512,Norbit,2007,60000000,95673607,35673607
7513,Music and Lyrics,2007,40000000,145896422,105896422
7514,Rendition,2007,27500000,24748670,-2751330
7515,Flawless,2007,20000000,6819587,-13180413
7521,In the Valley of Elah,2007,23000000,29541790,6541790
7523,Good Luck Chuck,2007,25000000,59192128,34192128
7526,Epic Movie,2007,20000000,86865564,66865564
7528,In the Land of Women,2007,10000000,17500000,7500000
7531,Battle for Terra,2007,4000000,6101046,2101046
7532,The Nanny Diaries,2007,20000000,47738099,27738099
7534,The Great Debaters,2007,15000000,30226144,15226144
7538,Freedom Writers,2007,21000000,41170784,20170784
7540,The Invisible,2007,30000000,26810113,-3189887
7546,We Own the Night,2007,21000000,54926886,33926886
7547,The Kite Runner,2007,20000000,73276047,53276047
7548,Vacancy,2007,19000000,35300645,16300645
7549,Dan in Real Life,2007,25000000,68377859,43377859
7551,Sydney White,2007,16500000,13620075,-2879925
7555,Captivity,2007,17000000,2626800,-14373200
7557,License to Wed,2007,35000000,69307224,34307224
7558,I Could Never Be Your Woman,2007,24000000,9576495,-14423505
7561,Michael Clayton,2007,25000000,92991835,67991835
7562,Lars and the Real Girl,2007,12000000,11293663,-706337
7565,The Water Horse,2007,45000000,103071443,58071443
7566,Death Sentence,2007,20000000,16974459,-3025541
7576,The Lookout,2007,16000000,5367030,-10632970
7585,Sicko,2007,9000000,24538513,15538513
7586,Pathfinder,2007,45000000,30822861,-14177139
7587,Gone Baby Gone,2007,19000000,34619699,15619699
7595,Walk Hard: The Dewey Cox Story,2007,35000000,18317151,-16682849
7601,Things We Lost in the Fire,2007,16000000,2849142,-13150858
7612,Reign Over Me,2007,20000000,22222308,2222308
7613,Love in the Time of Cholera,2007,45000000,4607608,-40392392
7617,I'm Not There.,2007,20000000,4001121,-15998879
7620,Gracie,2007,9000000,2955039,-6044961
7630,Earth,2007,15000000,109000000,94000000
7638,The Last Legion,2007,67000000,25303038,-41696962
7643,Whisper,2007,12000000,5285197,-6714803
7653,My Blueberry Nights,2007,10000000,21786738,11786738
7654,You Kill Me,2007,4000000,2426851,-1573149
7665,The Darjeeling Limited,2007,16000000,24377151,8377151
7667,Stomp the Yard,2007,13000000,75511123,62511123
7668,Virgin Territory,2007,38000000,5410749,-32589251
7675,Dead Silence,2007,20000000,22217407,2217407
7697,Battle in Seattle,2007,8000000,908847,-7091153
7707,Son of Rambow,2007,4000000,6870249,2870249
7708,I Think I Love My Wife,2007,11000000,13196245,2196245
7717,Hannibal Rising,2007,50000000,82169884,32169884
7733,Why Did I Get Married?,2007,15000000,55184721,40184721
7739,Ji jie hao,2007,16000000,34786960,18786960
7761,Daddy's Little Girls,2007,10000000,31609243,21609243
7785,Reno 911!: Miami,2007,10000000,20342161,10342161
7797,Code Name: The Cleaner,2007,20000000,10337477,-9662523
7819,No End in Sight,2007,2000000,1431623,-568377
7825,Alien,1979,11000000,104931801,93931801
7826,Apocalypse Now,1979,31500000,83471511,51971511
7828,Star Trek: The Motion Picture,1979,35000000,139000000,104000000
7829,Moonraker,1979,34000000,210300000,176300000
7830,Life of Brian,1979,4000000,20045115,16045115
7833,Rocky II,1979,7000000,200182160,193182160
7834,Caligola,1979,17500000,23438120,5938120
7839,Escape from Alcatraz,1979,8000000,43000000,35000000
7842,The Black Hole,1979,20000000,35841901,15841901
7847,The Concorde... Airport '79,1979,14000000,13015688,-984312
7848,Kramer vs. Kramer,1979,8000000,106260000,98260000
7851,1941,1979,35000000,31755742,-3244258
7854,Breaking Away,1979,2300000,20000000,17700000
7860,The Black Stallion,1979,2700000,37799643,35099643
7882,The Terminator,1984,6400000,78371200,71971200
7883,Indiana Jones and the Temple of Doom,1984,28000000,333000000,305000000
7884,Ghostbusters,1984,30000000,295212467,265212467
7885,Gremlins,1984,11000000,153083102,142083102
7886,The Neverending Story,1984,27000000,20158808,-6841192
7887,Beverly Hills Cop,1984,15000000,316360478,301360478
7889,Amadeus,1984,18000000,51973029,33973029
7890,The Karate Kid,1984,8000000,90815558,82815558
7891,A Nightmare on Elm Street,1984,1800000,25504513,23704513
7892,Conan the Destroyer,1984,18000000,31042035,13042035
7893,2010,1984,28000000,40400657,12400657
7894,Dune,1984,40000000,30925690,-9074310
7895,Romancing the Stone,1984,10000000,86572238,76572238
7896,Police Academy,1984,4500000,81198894,76698894
7898,Star Trek III: The Search for Spock,1984,18000000,87000000,69000000
7900,Footloose,1984,8200000,80035402,71835402
7902,Repo Man,1984,1500000,2300000,800000
7906,Starman,1984,22000000,28744356,6744356
7907,Bachelor Party,1984,6000000,38435947,32435947
7911,Sixteen Candles,1984,6500000,23686027,17186027
7912,The Killing Fields,1984,14400000,34700291,20300291
7913,Night of the Comet,1984,3000000,14418922,11418922
7916,The Last Starfighter,1984,15000000,28733290,13733290
7918,Sheena,1984,25000000,5778353,-19221647
7920,Splash,1984,8000000,69821334,61821334
7921,"Paris, Texas",1984,1746964,2181987,435023
7922,Body Double,1984,10000000,8801940,-1198060
7924,City Heat,1984,25000000,38348988,13348988
7927,The Cotton Club,1984,58000000,25928721,-32071279
7930,Top Secret!,1984,9000000,20458340,11458340
7936,Purple Rain,1984,7200000,68392977,61192977
7938,Missing in Action,1984,2550000,22812411,20262411
7940,The Natural,1984,28000000,47951979,19951979
7942,Children of the Corn,1984,800000,14000000,13200000
7946,A Passage to India,1984,8000000,27187653,19187653
7947,Streets of Fire,1984,14500000,8089290,-6410710
7948,Stop Making Sense,1984,1200000,4978922,3778922
7968,C.H.U.D.,1984,1250000,3412497,2162497
7969,Ghoulies,1984,1000000,35000000,34000000
7971,Best Defense,1984,18000000,19265302,1265302
7975,Razorback,1984,5500000,801000,-4699000
7978,Broadway Danny Rose,1984,8000000,10600497,2600497
7987,Return of the Jedi,1983,32350000,572700000,540350000
7988,Scarface,1983,25000000,65884703,40884703
7989,Never Say Never Again,1983,36000000,160000000,124000000
7990,Octopussy,1983,27500000,183700000,156200000
7992,Superman III,1983,39000000,75800000,36800000
7993,Trading Places,1983,40600000,90400000,49800000
7994,WarGames,1983,12000000,79567667,67567667
7995,National Lampoon's Vacation,1983,15000000,61399552,46399552
7996,Jaws 3,1983,20500000,87987055,67487055
8000,Sudden Impact,1983,22000000,67642693,45642693
8001,Risky Business,1983,6200000,63541777,57341777
8002,The Right Stuff,1983,27000000,21500000,-5500000
8005,Mickey's Christmas Carol,1983,3000000,21000000,18000000
8009,The Outsiders,1983,10000000,25697647,15697647
8010,Porky's II: The Next Day,1983,6500000,33759266,27259266
8015,Yentl,1983,12000000,30400000,18400000
8016,Blue Thunder,1983,22000000,42313354,20313354
8017,The Dead Zone,1983,10000000,20766616,10766616
8023,Flashdance,1983,4000000,92921203,88921203
8028,Twilight Zone: The Movie,1983,10000000,29450919,19450919
8032,Rumble Fish,1983,10000000,2494480,-7505520
8033,Staying Alive,1983,22000000,64892670,42892670
8034,Lone Wolf McQuade,1983,5000000,12232628,7232628
8036,Psycho II,1983,5000000,34725000,29725000
8039,Videodrome,1983,5952000,2120439,-3831561
8046,Fire and Ice,1983,1200000,760883,-439117
8050,Brainstorm,1983,15000000,10219460,-4780540
8054,The Keep,1983,6000000,3661757,-2338243
8058,Something Wicked This Way Comes,1983,19000000,5656087,-13343913
8066,Spacehunter: Adventures in the Forbidden Zone,1983,15000000,16500000,1500000
8067,Se7en,1995,33000000,327311859,294311859
8068,Toy Story,1995,30000000,361958736,331958736
8069,The Usual Suspects,1995,6000000,23341568,17341568
8070,Braveheart,1995,72000000,210000000,138000000
8071,GoldenEye,1995,58000000,352194034,294194034
8072,Jumanji,1995,65000000,262797249,197797249
8073,Die Hard: With a Vengeance,1995,90000000,366101666,276101666
8074,Species,1995,35000000,113000000,78000000
8075,Twelve Monkeys,1995,29500000,168840000,139340000
8076,Apollo 13,1995,52000000,355237933,303237933
8077,Bad Boys,1995,19000000,141407024,122407024
8078,Pocahontas,1995,55000000,346079773,291079773
8079,Heat,1995,60000000,187436818,127436818
8080,Before Sunrise,1995,2500000,5535405,3035405
8081,Judge Dredd,1995,90000000,113493481,23493481
8082,Batman Forever,1995,100000000,336529144,236529144
8083,Casino,1995,52000000,116112375,64112375
8085,Babe,1995,30000000,254134910,224134910
8086,Casper,1995,50000000,287928194,237928194
8088,Four Rooms,1995,4000000,4300000,300000
8089,Waterworld,1995,175000000,264218220,89218220
8091,Ace Ventura: When Nature Calls,1995,30000000,212385533,182385533
8092,The Bridges of Madison County,1995,24000000,182016617,158016617
8093,Leaving Las Vegas,1995,3600000,49800000,46200000
8094,The Net,1995,22000000,1106279658,1084279658
8096,Johnny Mnemonic,1995,26000000,19075720,-6924280
8097,Desperado,1995,7000000,25405445,18405445
8098,While You Were Sleeping,1995,17000000,182057016,165057016
8100,To Die For,1995,20000000,21284514,1284514
8101,Under Siege 2: Dark Territory,1995,60000000,104324083,44324083
8102,Cutthroat Island,1995,98000000,18517322,-79482678
8103,Mortal Kombat,1995,18000000,122195920,104195920
8104,Sense and Sensibility,1995,16500000,135000000,118500000
8105,Billy Madison,1995,10000000,26488734,16488734
8106,Mighty Morphin Power Rangers: The Movie,1995,15000000,66000000,51000000
8107,Get Shorty,1995,30250000,115101622,84851622
8108,Assassins,1995,50000000,30303072,-19696928
8109,The Quick and the Dead,1995,32000000,18552460,-13447540
8114,Tank Girl,1995,25000000,6600000,-18400000
8115,Friday,1995,3500000,28215918,24715918
8116,Dead Man Walking,1995,11000000,39363635,28363635
8117,Crimson Tide,1995,53000000,157387195,104387195
8118,Showgirls,1995,45000000,20350754,-24649246
8119,Mighty Aphrodite,1995,15000000,6700000,-8300000
8121,A Walk in the Clouds,1995,20000000,50012507,30012507
8124,Virtuosity,1995,30000000,24048000,-5952000
8128,Money Train,1995,60000000,35431113,-24568887
8130,Rob Roy,1995,28000000,31596911,3596911
8132,Hackers,1995,20000000,7563728,-12436272
8134,Nixon,1995,44000000,13681765,-30318235
8136,First Knight,1995,55000000,127600435,72600435
8137,Boys on the Side,1995,21000000,23450000,2450000
8138,Halloween: The Curse of Michael Myers,1995,5000000,15116634,10116634
8139,Fair Game,1995,50000000,11534477,-38465523
8144,The American President,1995,62000000,107879496,45879496
8148,Strange Days,1995,42000000,7959291,-34040709
8149,Living in Oblivion,1995,500000,1148752,648752
8152,Nick of Time,1995,8169363,8175346,5983
8154,Smoke,1995,7000000,8349430,1349430
8160,Screamers,1995,20000000,5781885,-14218115
8164,Kids,1995,1500000,7412216,5912216
8165,Losing Isaiah,1995,17000000,7603766,-9396234
8170,Jade,1995,50000000,9851610,-40148390
8178,Vampire in Brooklyn,1995,14000000,19800000,5800000
8179,Sudden Death,1995,35000000,64350171,29350171
8181,Things to Do in Denver When You're Dead,1995,8000000,529766,-7470234
8188,Congo,1995,50000000,152000000,102000000
8198,The Scarlet Letter,1995,50000000,10382407,-39617593
8199,Devil in a Blue Dress,1995,27000000,16140822,-10859178
8207,Now and Then,1995,12000000,27400000,15400000
8220,Waiting to Exhale,1995,16000000,81452156,65452156
8222,Le Hussard sur le toit,1995,35000000,15000000,-20000000
8224,How To Make An American Quilt,1995,10000000,23574130,13574130
8225,The Pebble and the Penguin,1995,28000000,3983912,-24016088
8229,Clockers,1995,25000000,13071518,-11928482
8241,Top Dog,1995,6000000,5093707,-906293
8242,Reservoir Dogs,1992,1200000,14661007,13461007
8243,Aladdin,1992,28000000,504050219,476050219
8244,Home Alone 2: Lost In New York,1992,18000000,358991681,340991681
8245,Batman Returns,1992,80000000,280000000,200000000
8246,AlienÂ³,1992,50000000,159773545,109773545
8247,Lethal Weapon 3,1992,35000000,321731527,286731527
8248,Dracula,1992,40000000,215862692,175862692
8250,Under Siege,1992,35000000,156563139,121563139
8252,A Few Good Men,1992,40000000,243240178,203240178
8253,Wayne's World,1992,20000000,121697323,101697323
8255,Basic Instinct,1992,49000000,352927224,303927224
8257,Glengarry Glen Ross,1992,12500000,10725228,-1774772
8258,Honey I Blew Up the Kid,1992,40000000,58662452,18662452
8260,Bad Lieutenant,1992,1000000,2019469,1019469
8261,Unforgiven,1992,14000000,159157447,145157447
8262,Sister Act,1992,31000000,231605150,200605150
8264,1492: Conquest of Paradise,1992,47000000,7191399,-39808601
8265,Pet Sematary II,1992,8000000,17092453,9092453
8266,Scent of a Woman,1992,31000000,134095253,103095253
8267,Passenger 57,1992,15000000,44065653,29065653
8269,Fortress,1992,8000000,6739141,-1260859
8271,The Bodyguard,1992,25000000,411006740,386006740
8277,Patriot Games,1992,45000000,178051587,133051587
8278,The Mighty Ducks,1992,10000000,50752337,40752337
8279,Twin Peaks: Fire Walk with Me,1992,10000000,4160851,-5839149
8280,The Player,1992,8000000,21706101,13706101
8281,Hellraiser III: Hell on Earth,1992,5000000,12534961,7534961
8282,Malcolm X,1992,34000000,48169908,14169908
8287,The Last of the Mohicans,1992,40000000,75505856,35505856
8289,The Hand that Rocks the Cradle,1992,11700000,88036683,76336683
8290,Bitter Moon,1992,5000000,1862805,-3137195
8294,City of Joy,1992,27000000,14683921,-12316079
8299,A League of Their Own,1992,40000000,107458785,67458785
8302,My Cousin Vinny,1992,11000000,64088552,53088552
8304,The Crying Game,1992,3705538,62548947,58843409
8306,Boomerang,1992,40000000,70100000,30100000
8307,The Lawnmower Man,1992,10000000,32101000,22101000
8308,Candyman,1992,6000000,25792310,19792310
8313,Unlawful Entry,1992,23000000,57138719,34138719
8314,Captain Ron,1992,24000000,22518097,-1481903
8315,Memoirs of an Invisible Man,1992,40000000,14358033,-25641967
8318,Rapid Fire,1992,10000000,14356479,4356479
8323,Far and Away,1992,60000000,137783840,77783840
8324,Radio Flyer,1992,35000000,4651977,-30348023
8325,Juice,1992,5000000,20146880,15146880
8327,Seong lung wui,1992,10000000,8359717,-1640283
8330,Single White Female,1992,16000000,48017402,32017402
8342,Jennifer Eight,1992,20000000,11390479,-8609521
8350,Diggstown,1992,17000000,4836637,-12163363
8352,Raising Cain,1992,12000000,37170057,25170057
8367,Strictly Ballroom,1992,3000000,33946224,30946224
8375,Raiders of the Lost Ark,1981,18000000,389925971,371925971
8376,Private Lessons,1981,2800000,26279000,23479000
8377,For Your Eyes Only,1981,28000000,195312802,167312802
8378,The Fox and the Hound,1981,12000000,29800000,17800000
8379,Mad Max 2,1981,2000000,24600832,22600832
8380,History of the World: Part I,1981,11000000,31672907,20672907
8381,An American Werewolf in London,1981,10000000,31973249,21973249
8384,Escape from New York,1981,6000000,50000000,44000000
8387,Chariots of Fire,1981,5500000,58972904,53472904
8388,Friday the 13th Part 2,1981,1250000,21722776,20472776
8391,Halloween II,1981,2500000,25533818,23033818
8393,Arthur,1981,7000000,95461682,88461682
8396,Porky's,1981,4000000,125728258,121728258
8397,Reds,1981,32000000,40382659,8382659
8398,The Cannonball Run,1981,18000000,72179579,54179579
8399,Absence of Malice,1981,12000000,40716963,28716963
8400,Time Bandits,1981,5000000,42365581,37365581
8401,Scanners,1981,4100000,14225876,10125876
8405,Stripes,1981,10000000,85300000,75300000
8406,Outland,1981,16000000,17374595,1374595
8410,Blow Out,1981,18000000,12000000,-6000000
8415,Dragonslayer,1981,18000000,6000000,-12000000
8418,The Howling,1981,1000000,17985893,16985893
8419,Nighthawks,1981,5000000,19905359,14905359
8421,Taps,1981,14000000,35856053,21856053
8425,Clash of the Titans,1981,15000000,41092328,26092328
8444,Neighbors,1981,8500000,29916207,21416207
8457,Independence Day,1996,75000000,816969268,741969268
8458,Mission: Impossible,1996,80000000,457696359,377696359
8459,Trainspotting,1996,4000000,16491080,12491080
8460,Fargo,1996,7000000,60611975,53611975
8461,The Rock,1996,75000000,335062621,260062621
8462,Mars Attacks!,1996,70000000,101371017,31371017
8463,Romeo + Juliet,1996,14500000,147298761,132798761
8464,The Hunchback of Notre Dame,1996,100000000,100138851,138851
8466,Space Jam,1996,80000000,230000000,150000000
8467,Eraser,1996,100000000,242295562,142295562
8468,101 Dalmatians,1996,54000000,320689294,266689294
8469,Phenomenon,1996,32000000,152036382,120036382
8470,From Dusk Till Dawn,1996,19000000,25836616,6836616
8471,A Time to Kill,1996,40000000,152266007,112266007
8472,Star Trek: First Contact,1996,46000000,150000000,104000000
8473,Happy Gilmore,1996,12000000,41205099,29205099
8474,Jingle All the Way,1996,60000000,129832389,69832389
8475,Scream,1996,14000000,173046663,159046663
8476,The Long Kiss Goodnight,1996,65000000,89456761,24456761
8477,Jerry Maguire,1996,50000000,273552592,223552592
8478,Matilda,1996,36000000,33459416,-2540584
8479,DragonHeart,1996,57000000,115267375,58267375
8480,The Nutty Professor,1996,54000000,128769345,74769345
8481,Daylight,1996,80000000,159212469,79212469
8482,The Quest,1996,30000000,57400547,27400547
8483,Chain Reaction,1996,50000000,60209334,10209334
8484,The English Patient,1996,27000000,231976425,204976425
8485,Executive Decision,1996,55000000,121969216,66969216
8486,Twister,1996,92000000,494471524,402471524
8487,Ransom,1996,80000000,309492681,229492681
8489,The Cable Guy,1996,47000000,102825796,55825796
8490,Sleepers,1996,44000000,165615285,121615285
8491,The Frighteners,1996,30000000,29359216,-640784
8492,Broken Arrow,1996,50000000,150270147,100270147
8494,Escape from L.A.,1996,50000000,42277365,-7722635
8495,The People vs. Larry Flynt,1996,36000000,20300385,-15699615
8496,The Arrival,1996,25000000,14048372,-10951628
8497,Bound,1996,4500000,7011317,2511317
8499,Striptease,1996,50000000,113309743,63309743
8500,The Fan,1996,55000000,18626419,-36373581
8501,Jack,1996,45000000,58620973,13620973
8502,Primal Fear,1996,30000000,102616183,72616183
8504,Courage Under Fire,1996,46000000,100860818,54860818
8510,Set  It Off,1996,9000000,41590886,32590886
8512,The Craft,1996,15000000,24769466,9769466
8515,Hellraiser: Bloodline,1996,4000000,16675000,12675000
8517,Kingpin,1996,27000000,25023434,-1976566
8518,The Preacher's Wife,1996,40000000,48093211,8093211
8521,Bulletproof,1996,25000000,22611954,-2388046
8524,Evita,1996,55000000,141047179,86047179
8528,Flirting with Disaster,1996,7000000,14702438,7702438
8532,Basquiat,1996,2962051,3011195,49144
8535,Last Man Standing,1996,67000000,47267001,-19732999
8536,Maximum Risk,1996,25000000,51702483,26702483
8537,Fled,1996,25000000,17193231,-7806769
8540,She's the One,1996,3500000,9482579,5982579
8544,The Crow: City of Angels,1996,13000000,17917287,4917287
8547,Bottle Rocket,1996,7000000,560069,-6439931
8548,James and the Giant Peach,1996,38000000,28921264,-9078736
8550,Emma,1996,6000000,22231658,16231658
8552,Tin Cup,1996,45000000,53854588,8854588
8554,The First Wives Club,1996,26000000,116400000,90400000
8556,Kama Sutra - A Tale of Love,1996,3000000,4109095,1109095
8557,Sling Blade,1996,1000000,24475416,23475416
8558,Secrets & Lies,1996,4500000,13417292,8917292
8563,Mary Reilly,1996,47000000,12379402,-34620598
8565,The Ghost and the Darkness,1996,50000000,75000000,25000000
8575,Lone Star,1996,5000000,13269963,8269963
8576,Flipper,1996,25530000,20080020,-5449980
8586,The Chamber,1996,50000000,22540359,-27459641
8587,White Squall,1996,38000000,10300000,-27700000
8593,The Phantom,1996,45000000,17300889,-27699111
8598,Extreme Measures,1996,38000000,17380126,-20619874
8602,Michael Collins,1996,28000000,16900000,-11100000
8615,Doctor Who,1996,5000000,42000000,37000000
8621,Ridicule,1996,3000000,2503829,-496171
8622,The Island of Dr. Moreau,1996,40000000,49627779,9627779
8652,Joe's Apartment,1996,13000000,4619014,-8380986
8653,Bad Moon,1996,7000000,1100000,-5900000
8654,Mrs. Winterbourne,1996,25000000,10070000,-14930000
8661,Gladiator,2000,103000000,457640427,354640427
8662,Memento,2000,9000000,39723096,30723096
8663,How the Grinch Stole Christmas,2000,123000000,345141403,222141403
8664,Cast Away,2000,90000000,429632142,339632142
8665,Snatch,2000,10000000,83557872,73557872
8666,Mission: Impossible II,2000,125000000,546388105,421388105
8667,Bedazzled,2000,48000000,90383208,42383208
8668,Scary Movie,2000,19000000,278019771,259019771
8669,The Emperor's New Groove,2000,100000000,169327687,69327687
8670,What Women Want,2000,70000000,374111707,304111707
8671,Dinosaur,2000,127500000,354248063,226748063
8672,Charlie's Angels,2000,92000000,264105545,172105545
8673,Chicken Run,2000,45000000,224834564,179834564
8674,The Patriot,2000,110000000,215294342,105294342
8675,Final Destination,2000,23000000,53302314,30302314
8676,Coyote Ugly,2000,45000000,113916474,68916474
8677,Romeo Must Die,2000,25000000,91036760,66036760
8678,U-571,2000,62000000,127666415,65666415
8679,Billy Elliot,2000,5000000,110000000,105000000
8680,Gone In Sixty Seconds,2000,90000000,237202299,147202299
8681,Erin Brockovich,2000,52000000,256271286,204271286
8682,Meet the Parents,2000,55000000,330444045,275444045
8683,"O Brother, Where Art Thou?",2000,26000000,71000000,45000000
8684,Pitch Black,2000,23000000,53187659,30187659
8685,Boiler Room,2000,26000000,28780255,2780255
8686,The Road to El Dorado,2000,95000000,76432727,-18567273
8687,Miss Congeniality,2000,45000000,212000000,167000000
8688,Frequency,2000,31000000,68106245,37106245
8689,Requiem for a Dream,2000,4500000,7390108,2890108
8690,Pay It Forward,2000,40000000,55707411,15707411
8692,Hollow Man,2000,95000000,190213455,95213455
8693,Big Momma's House,2000,30000000,173959438,143959438
8694,American Psycho,2000,7000000,34266564,27266564
8695,Dancer in the Dark,2000,12800000,40031879,27231879
8696,Road Trip,2000,16000000,119754278,103754278
8697,Remember the Titans,2000,30000000,136706683,106706683
8698,The Gift,2000,10000000,12008642,2008642
8699,The Legend of Bagger Vance,2000,80000000,39459427,-40540573
8700,Traffic,2000,48000000,207515725,159515725
8701,"Dude, Whereâ€™s My Car?",2000,13000000,73180723,60180723
8702,The Family Man,2000,60000000,124745083,64745083
8704,The 6th Day,2000,82000000,96085477,14085477
8705,The Skulls,2000,15000000,35007180,20007180
8707,"Me, Myself & Irene",2000,51000000,149270999,98270999
8708,Shanghai Noon,2000,55000000,56932305,1932305
8709,Unbreakable,2000,75000000,248118121,173118121
8710,Space Cowboys,2000,65000000,128884132,63884132
8711,The Whole Nine Yards,2000,41300000,106371651,65071651
8712,Almost Famous,2000,60000000,47383689,-12616311
8713,Bring It On,2000,28000000,90449929,62449929
8714,Chocolat,2000,25000000,152500343,127500343
8715,High Fidelity,2000,30000000,47126295,17126295
8716,Red Planet,2000,80000000,33463969,-46536031
8717,Mission to Mars,2000,90000000,60874615,-29125385
8718,The Cell,2000,33000000,104155843,71155843
8719,Shaft,2000,46000000,107196498,61196498
8721,Get Carter,2000,63600000,19412993,-44187007
8724,The Flintstones in Viva Rock Vegas,2000,83000000,59468275,-23531725
8726,Thirteen Days,2000,80000000,34566746,-45433254
8727,The Beach,2000,40000000,144056873,104056873
8730,The Perfect Storm,2000,120000000,325756637,205756637
8734,Titan A.E.,2000,75000000,36754634,-38245366
8736,Scream 3,2000,40000000,161834276,121834276
8738,Vertical Limit,2000,75000000,215663859,140663859
8739,Reindeer Games,2000,42000000,32168970,-9831030
8743,The Tigger Movie,2000,30000000,45554533,15554533
8744,Next Friday,2000,11000000,59827328,48827328
8745,Dracula 2000,2000,28000000,33000337,5000337
8749,Urban Legends: Final Cut,2000,14000000,38574362,24574362
8750,Men of Honor,2000,32000000,48814909,16814909
8751,What Lies Beneath,2000,100000000,155464351,55464351
8752,Rules of Engagement,2000,60000000,71000000,11000000
8753,Finding Forrester,2000,43000000,80049764,37049764
8757,Boys and Girls,2000,16000000,20627372,4627372
8759,102 Dalmatians,2000,85000000,183611771,98611771
8760,Nutty Professor II: The Klumps,2000,84000000,123307945,39307945
8762,Keeping the Faith,2000,30000000,37036004,7036004
8765,Supernova,2000,90000000,14828081,-75171919
8769,Bounce,2000,35000000,36779296,1779296
8775,The Art of War,2000,40000000,30199105,-9800895
8776,Whatever It Takes,2000,15000000,9902115,-5097885
8778,The Kid,2000,65000000,69700000,4700000
8781,Highlander: Endgame,2000,25000000,15843608,-9156392
8782,Love & Basketball,2000,20000000,27728118,7728118
8788,Gossip,2000,14000000,5108820,-8891180
8789,Quills,2000,13500000,7060876,-6439124
8791,The Next Best Thing,2000,25000000,24362772,-637228
8793,Dungeons & Dragons,2000,35000000,15185241,-19814759
8795,The Ladies Man,2000,24000000,13700000,-10300000
8797,Hamlet,2000,2000000,1568749,-431251
8799,Ready to Rumble,2000,24000000,12372410,-11627590
8801,Center Stage,2000,18000000,17200925,-799075
8804,Return to Me,2000,24000000,36609995,12609995
8808,Saving Grace,2000,10000000,26330482,16330482
8809,The Broken Hearts Club: A Romantic Comedy,2000,1000000,1744858,744858
8815,Drowning Mona,2000,16000000,15427192,-572808
8817,Gun Shy,2000,10000000,1631839,-8368161
8826,X-Men,2000,75000000,157299717,82299717
8860,The Little Vampire,2000,22000000,13555988,-8444012
8862,Shadow of the Vampire,2000,8000000,8279017,279017
8866,The Adventures of Rocky & Bullwinkle,2000,76000000,35134820,-40865180
8868,The Big Kahuna,2000,7000000,3728888,-3271112
8881,Hanging Up,2000,40000000,36037909,-3962091
8883,The In Crowd,2000,15000000,5217498,-9782502
8888,Blade Runner,1982,28000000,32768670,4768670
8889,E.T. the Extra-Terrestrial,1982,10500000,792910554,782410554
8890,The Thing,1982,10000000,13782838,3782838
8891,First Blood,1982,15000000,125212904,110212904
8893,Tron,1982,17000000,33000000,16000000
8894,Rocky III,1982,17000000,124000000,107000000
8895,Poltergeist,1982,10700000,122200000,111500000
8896,Conan the Barbarian,1982,20000000,68851475,48851475
8897,48 Hrs.,1982,1000000,78868508,77868508
8898,Star Trek II: The Wrath of Khan,1982,12000000,96800000,84800000
8899,Fast Times at Ridgemont High,1982,4500000,27092880,22592880
8901,The Dark Crystal,1982,15000000,40577001,25577001
8903,Gandhi,1982,22000000,77737889,55737889
8904,Tootsie,1982,21000000,177200000,156200000
8911,The Secret of NIMH,1982,7000000,14665733,7665733
8916,Sophie's Choice,1982,12000000,30036000,18036000
8918,Grease 2,1982,13200000,15171476,1971476
8919,Creepshow,1982,8000000,21028755,13028755
8920,Annie,1982,50000000,57059003,7059003
8928,The Year of Living Dangerously,1982,6000000,10278575,4278575
8930,Friday the 13th Part III,1982,4000000,36690067,32690067
8932,Halloween III: Season of the Witch,1982,2500000,14400000,11900000
8933,The Verdict,1982,16000000,53977250,37977250
8936,Firefox,1982,18000000,70687344,52687344
8950,The Man from Snowy River,1982,3500000,20659423,17159423
8969,The Truman Show,1998,60000000,264118201,204118201
8970,Armageddon,1998,140000000,553799566,413799566
8971,Mulan,1998,90000000,304320254,214320254
8972,Blade,1998,45000000,131183530,86183530
8973,The Big Lebowski,1998,15000000,27739163,12739163
8974,Saving Private Ryan,1998,70000000,481840909,411840909
8976,Rush Hour,1998,33000000,244386864,211386864
8977,A Bug's Life,1998,120000000,363398565,243398565
8978,The Prince of Egypt,1998,70000000,218613188,148613188
8979,Antz,1998,60000000,171757863,111757863
8981,Ronin,1998,55000000,41610884,-13389116
8982,Dark City,1998,27000000,27200316,200316
8984,Wild Things,1998,20000000,67200000,47200000
8985,There's Something About Mary,1998,23000000,369884651,346884651
8986,The X Files,1998,66000000,189198313,123198313
8987,American History X,1998,20000000,23875127,3875127
8988,What Dreams May Come,1998,85000000,71485043,-13514957
8989,Enemy of the State,1998,90000000,250649836,160649836
8991,Deep Impact,1998,75000000,140464664,65464664
8992,Lost in Space,1998,80000000,136159423,56159423
8993,The Negotiator,1998,50000000,44547681,-5452319
8994,Meet Joe Black,1998,90000000,142940100,52940100
8995,Lethal Weapon 4,1998,140000000,285444603,145444603
8996,I Still Know What You Did Last Summer,1998,65000000,40002112,-24997888
8997,Godzilla,1998,130000000,379014294,249014294
8998,Practical Magic,1998,75000000,46683377,-28316623
8999,Sphere,1998,75000000,13100000,-61900000
9000,Six Days Seven Nights,1998,70000000,164000000,94000000
9001,Fear and Loathing in Las Vegas,1998,18500000,10680275,-7819725
9002,Shakespeare in Love,1998,25000000,289317794,264317794
9003,The Mask of Zorro,1998,95000000,250288523,155288523
9004,The Waterboy,1998,23000000,185991646,162991646
9005,A Perfect Murder,1998,60000000,128038368,68038368
9007,City of Angels,1998,55000000,198685114,143685114
9009,The Thin Red Line,1998,52000000,98126565,46126565
9011,Small Soldiers,1998,40000000,54682547,14682547
9012,Doctor Dolittle,1998,71000000,294456605,223456605
9013,Star Trek: Insurrection,1998,70000000,118000000,48000000
9014,You've Got Mail,1998,65000000,250821495,185821495
9015,U.S. Marshals,1998,60000000,102367405,42367405
9016,Elizabeth,1998,30000000,82150642,52150642
9017,Out of Sight,1998,48000000,77745568,29745568
9018,The Wedding Singer,1998,18000000,123306987,105306987
9020,EverAfter,1998,26000000,65705772,39705772
9021,Patch Adams,1998,50000000,202292902,152292902
9023,Urban Legend,1998,14000000,72527595,58527595
9025,Rounders,1998,12000000,22921898,10921898
9027,Disturbing Behavior,1998,15000000,17507368,2507368
9028,Babe: Pig in the City,1998,90000000,69131860,-20868140
9030,"Lock, Stock and Two Smoking Barrels",1998,1350000,3897569,2547569
9034,A Night at the Roxbury,1998,17000000,30331165,13331165
9035,The Horse Whisperer,1998,60000000,186883563,126883563
9038,Bride of Chucky,1998,25000000,50671850,25671850
9040,54,1998,13000000,16757163,3757163
9041,Great Expectations,1998,25000000,55494066,30494066
9043,The Siege,1998,70000000,116672912,46672912
9044,Snake Eyes,1998,73000000,103891409,30891409
9047,Sliding Doors,1998,6000000,58000000,52000000
9051,The Avengers,1998,60000000,48522832,-11477168
9054,Simon Birch,1998,20000000,18253415,-1746585
9055,The Big Hit,1998,13000000,27007143,14007143
9057,Blues Brothers 2000,1998,28000000,14051384,-13948616
9058,He Got Game,1998,25000000,21567853,-3432147
9059,Hard Rain,1998,70000000,19870567,-50129433
9060,A Civil Action,1998,70000000,56702901,-13297099
9063,Happiness,1998,3000000,2807390,-192610
9064,The Replacement Killers,1998,30000000,19204929,-10795071
9072,The Faculty,1998,15000000,40283321,25283321
9073,Playing by Heart,1998,20000000,3970078,-16029922
9083,Can't Hardly Wait,1998,10000000,25605015,15605015
9084,Halloween: H20,1998,17000000,55041738,38041738
9085,Psycho,1998,60000000,37141130,-22858870
9088,Deep Rising,1998,45000000,11203026,-33796974
9089,The Red Violin,1998,18000000,9495408,-8504592
9091,Very Bad Things,1998,30000000,9898412,-20101588
9092,Soldier,1998,75000000,14567883,-60432117
9094,The Opposite of Sex,1998,5000000,5879254,879254
9104,Bulworth,1998,30000000,29202884,-797116
9114,Buffalo '66,1998,1500000,2375097,875097
9115,Half Baked,1998,8000000,17460020,9460020
9118,Gods and Monsters,1998,10000000,6451628,-3548372
9119,Without Limits,1998,25000000,777423,-24222577
9121,Jane Austen's Mafia!,1998,10000000,19000000,9000000
9123,Zero Effect,1998,5000000,1980338,-3019662
9134,Edge of Seventeen,1998,1500000,870751,-629249
9141,Home Fries,1998,15000000,10443316,-4556684
9145,Strangeland,1998,1100000,631221,-468779
9147,The Object of My Affection,1998,15000000,46905889,31905889
9152,The Newton Boys,1998,27000000,76000000,49000000
9153,How Stella Got Her Groove Back,1998,20000000,37672350,17672350
9179,The Little Mermaid,1989,40000000,211343479,171343479
9180,Indiana Jones and the Last Crusade,1989,48000000,474171806,426171806
9181,When Harry Met Sally...,1989,16000000,92823546,76823546
9182,Batman,1989,35000000,411348924,376348924
9183,Back to the Future Part II,1989,40000000,332000000,292000000
9184,Dead Poets Society,1989,16400000,235860116,219460116
9185,Ghostbusters II,1989,37000000,215394738,178394738
9186,Licence to Kill,1989,32000000,156167015,124167015
9187,National Lampoon's Christmas Vacation,1989,27000000,71320000,44320000
9188,Glory,1989,18000000,26828365,8828365
9189,The Abyss,1989,70000000,90000098,20000098
9190,Lethal Weapon 2,1989,25000000,227853986,202853986
9191,Tango & Cash,1989,55000000,63408614,8408614
9192,Bill & Ted's Excellent Adventure,1989,10000000,40485039,30485039
9193,Look Who's Talking,1989,7500000,296000000,288500000
9194,"Honey, I Shrunk the Kids",1989,32000000,222724172,190724172
9195,Star Trek V: The Final Frontier,1989,30000000,70200000,40200000
9196,Kickboxer,1989,1500000,14697005,13197005
9197,A Nightmare on Elm Street 5: The Dream Child,1989,8000000,22168359,14168359
9198,Cyborg,1989,500000,10166459,9666459
9199,The 'Burbs,1989,18000000,36602000,18602000
9200,Pet Sematary,1989,11500000,57469467,45969467
9202,"See No Evil, Hear No Evil",1989,18000000,46908987,28908987
9203,Born on the Fourth of July,1989,14000000,161001698,147001698
9204,Uncle Buck,1989,15000000,79258538,64258538
9207,Major League,1989,11000000,49797148,38797148
9209,Weekend at Bernie's,1989,6500000,30218387,23718387
9211,K-9,1989,18598420,78247647,59649227
9212,Casualties of War,1989,22500000,18671317,-3828683
9218,Friday the 13th Part VIII: Jason Takes Manhattan,1989,5000000,14000000,9000000
9219,Always,1989,31000000,74134790,43134790
9222,Miracle Mile,1989,3000000,1145404,-1854596
9226,All Dogs Go to Heaven,1989,13800000,27100027,13300027
9228,Harlem Nights,1989,30000000,60864870,30864870
9229,Sea of Love,1989,19000000,110879513,91879513
9231,Dead Calm,1989,10000000,7825000,-2175000
9234,Shocker,1989,5000000,16554699,11554699
9236,Driving Miss Daisy,1989,7500000,145793296,138293296
9238,Crimes and Misdemeanors,1989,19000000,18254702,-745298
9239,Black Rain,1989,30000000,45892212,15892212
9247,My Left Foot: The Story of Christy Brown,1989,645180,14743391,14098211
9254,Do the Right Thing,1989,6500000,37295445,30795445
9264,Halloween 5: The Revenge of Michael Myers,1989,5000000,11642254,6642254
9267,Next of Kin,1989,12000000,15942628,3942628
9276,Road House,1989,15000000,30050028,15050028
9277,Fletch Lives,1989,8045760,35150960,27105200
9284,Three Fugitives,1989,15000000,40590000,25590000
9287,Valmont,1989,33000000,1132112,-31867888
9288,Drugstore Cowboy,1989,2500000,4729352,2229352
9289,The Wizard,1989,6000000,14278900,8278900
9303,Little Monsters,1989,7000000,793775,-6206225
9316,Beauty and the Beast,1991,25000000,377350553,352350553
9317,Terminator 2: Judgment Day,1991,100000000,520000000,420000000
9318,Hook,1991,70000000,300854823,230854823
9319,Robin Hood: Prince of Thieves,1991,48000000,390493908,342493908
9320,Highlander II: The Quickening,1991,30000000,15556340,-14443660
9321,Cape Fear,1991,35000000,182300000,147300000
9322,Star Trek VI: The Undiscovered Country,1991,27000000,96900000,69900000
9323,The Naked Gun 2Â½: The Smell of Fear,1991,23000000,86930411,63930411
9324,Point Break,1991,24000000,83531958,59531958
9326,Backdraft,1991,75000000,152368585,77368585
9327,The Addams Family,1991,30000000,191502426,161502426
9328,Hudson Hawk,1991,65000000,17218080,-47781920
9329,The Rocketeer,1991,42000000,62000000,20000000
9330,Thelma & Louise,1991,16000000,45361000,29361000
9331,The Doors,1991,38000000,34416893,-3583107
9333,Nothing but Trouble,1991,40000000,8479793,-31520207
9335,The Silence of the Lambs,1991,19000000,272742922,253742922
9336,Barton Fink,1991,9000000,6153939,-2846061
9339,Freddy's Dead: The Final Nightmare,1991,11000000,34872033,23872033
9341,The Last Boy Scout,1991,29000000,59509925,30509925
9342,JFK,1991,40000000,205405498,165405498
9343,Boyz n the Hood,1991,6500000,57504069,51004069
9344,Harley Davidson and the Marlboro Man,1991,23000000,7434726,-15565274
9345,Double Impact,1991,15000000,30102717,15102717
9347,What About Bob?,1991,35000000,63710000,28710000
9349,Child's Play 3,1991,13000000,20560255,7560255
9351,City Slickers,1991,26000000,124033791,98033791
9352,Hot Shots!,1991,26000000,181096164,155096164
9354,Return to the Blue Lagoon,1991,11000000,2807854,-8192146
9356,Fried Green Tomatoes,1991,11000000,119418501,108418501
9358,Showdown in Little Tokyo,1991,8000000,2275557,-5724443
9359,Sleeping with the Enemy,1991,19000000,174999005,155999005
9361,Rock-A-Doodle,1991,18000000,11657385,-6342615
9368,The Fisher King,1991,24000000,41895491,17895491
9371,Don't Tell Mom the Babysitter's Dead,1991,10000000,25196249,15196249
9372,Shadows and Fog,1991,14000000,2735731,-11264269
9373,Bugsy,1991,30000000,49114016,19114016
9374,Cool as Ice,1991,6000000,1193062,-4806938
9375,Out for Justice,1991,14000000,39673161,25673161
9380,The Prince of Tides,1991,30000000,74787599,44787599
9382,Jungle Fever,1991,14000000,32482682,18482682
9396,New Jack City,1991,8500000,47624253,39124253
9397,A Rage in Harlem,1991,8000000,10400000,2400000
9400,Oscar,1991,35000000,23562716,-11437284
9418,Mobsters,1991,23000000,20246790,-2753210
9426,Shattered,1991,22000000,11511031,-10488969
9427,White Fang,1991,14000000,34793160,20793160
9432,Dutch,1991,17000000,4603929,-12396071
9435,Mannequin Two: On the Move,1991,13000000,3752426,-9247574
9449,Die Hard,1988,28000000,140767956,112767956
9450,Big,1988,18000000,151668774,133668774
9451,The Naked Gun: From the Files of Police Squad!,1988,12000000,78756177,66756177
9452,License to Drive,1988,8000000,22433275,14433275
9453,Beetlejuice,1988,15000000,73326666,58326666
9454,Rain Man,1988,25000000,354825435,329825435
9455,Bloodsport,1988,1500000,11806119,10306119
9456,Coming to America,1988,39000000,288752301,249752301
9457,Rambo III,1988,63000000,189015611,126015611
9460,Twins,1988,15000000,216614388,201614388
9461,Who Framed Roger Rabbit,1988,70000000,329803958,259803958
9462,The Land Before Time,1988,12300000,84460846,72160846
9463,Cocktail,1988,20000000,171504781,151504781
9465,Child's Play,1988,9000000,44196684,35196684
9466,Willow,1988,35000000,57269863,22269863
9468,A Nightmare on Elm Street 4: The Dream Master,1988,7000000,72500000,65500000
9470,Bull Durham,1988,7000000,50888000,43888000
9471,Red Heat,1988,29000000,34994648,5994648
9472,A Fish Called Wanda,1988,7500000,62493712,54993712
9475,The Blob,1988,19000000,8247943,-10752057
9476,Cocoon: The Return,1988,17500000,25024919,7524919
9481,Mississippi Burning,1988,15000000,34604000,19604000
9483,Working Girl,1988,28000000,103173635,75173635
9484,They Live,1988,4000000,13008928,9008928
9485,Phantasm II,1988,3000000,7282851,4282851
9488,Halloween 4: The Return of Michael Myers,1988,5000000,17768757,12768757
9489,Action Jackson,1988,7000000,20256975,13256975
9490,Married to the Mob,1988,10000000,21486757,11486757
9492,Friday the 13th Part VII: The New Blood,1988,2800000,19170001,16370001
9494,Dangerous Liaisons,1988,14000000,34670720,20670720
9495,My Stepmother is an Alien,1988,20000000,13854000,-6146000
9496,Frantic,1988,20000000,17637950,-2362050
9503,Return of the Living Dead Part II,1988,6200000,9205924,3005924
9508,Poltergeist III,1988,10500000,14144000,3644000
9512,Midnight Run,1988,30000000,38413606,8413606
9514,Above the Law,1988,7500000,18869631,11369631
9515,The Last Temptation of Christ,1988,7000000,8373585,1373585
9524,The Great Outdoors,1988,24000000,43455230,19455230
9530,Dead Ringers,1988,13000000,8038508,-4961492
9532,Ernest Saves Christmas,1988,6000000,28202109,22202109
9535,Bad Dreams,1988,4000000,9797098,5797098
9540,Night of the Demons,1988,1200000,3109904,1909904
9542,Talk Radio,1988,4000000,3468572,-531428
9544,Earth Girls Are Easy,1988,10000000,3916303,-6083697
9554,Punchline,1988,15000000,21032267,6032267
9555,Critters 2,1988,4500000,3813293,-686707
9557,Monkey Shines,1988,7000000,5344577,-1655423
9564,Powaqqatsi,1988,2500000,589244,-1910756
9565,The Serpent and the Rainbow,1988,7000000,19595031,12595031
9568,Colors,1988,6000000,46616067,40616067
9569,Biloxi Blues,1988,20000000,51684798,31684798
9571,Vampire's Kiss,1988,2000000,725131,-1274869
9578,The Lair of the White Worm,1988,2500000,1189315,-1310685
9585,A Cry in the Dark,1988,15000000,6908797,-8091203
9587,Red Scorpion,1988,16000000,4192440,-11807560
9590,The New Adventures of Pippi Longstocking,1988,5000000,3569939,-1430061
9594,Predator,1987,18000000,98235548,80235548
9595,Full Metal Jacket,1987,17000000,46357676,29357676
9596,Dirty Dancing,1987,6000000,213954274,207954274
9597,Spaceballs,1987,22700000,38119483,15419483
9598,The Living Daylights,1987,40000000,191185897,151185897
9599,RoboCop,1987,13000000,53000000,40000000
9600,Evil Dead II,1987,3600000,5923044,2323044
9601,Lethal Weapon,1987,15000000,120207127,105207127
9602,The Running Man,1987,27000000,38122105,11122105
9603,Jaws: The Revenge,1987,23000000,51881013,28881013
9604,The Princess Bride,1987,16000000,30857814,14857814
9605,A Nightmare on Elm Street 3: Dream Warriors,1987,5000000,44793222,39793222
9606,Wall Street,1987,15000000,43848069,28848069
9607,Beverly Hills Cop II,1987,20000000,299965036,279965036
9608,Superman IV: The Quest for Peace,1987,17000000,19300000,2300000
9609,Raising Arizona,1987,6000000,29180280,23180280
9610,The Untouchables,1987,25000000,76270454,51270454
9611,"Good Morning, Vietnam",1987,13000000,123922370,110922370
9612,The Last Emperor,1987,23000000,43984230,20984230
9613,Fatal Attraction,1987,14000000,320145693,306145693
9617,Angel Heart,1987,17000000,17185632,185632
9618,Over the Top,1987,25000000,16057580,-8942420
9620,The Lost Boys,1987,8500000,32222567,23722567
9622,Creepshow 2,1987,3500000,14000000,10500000
9624,Overboard,1987,1880006,26713187,24833181
9625,Barfly,1987,3000000,3221568,221568
9626,Broadcast News,1987,20000000,51249404,31249404
9628,Blind Date,1987,18000000,39321715,21321715
9630,Dragnet,1987,20000000,66673516,46673516
9634,The Pick-up Artist,1987,15000000,13290368,-1709632
9641,No Way Out,1987,15000000,35509515,20509515
9643,The Secret of My Success,1987,12000000,110996879,98996879
9646,Three Men and a Baby,1987,11000000,168000000,157000000
9651,Prince of Darkness,1987,3000000,14182492,11182492
9653,Hellraiser,1987,1000000,14564027,13564027
9654,Mio min Mio,1987,7200000,2300000,-4900000
9659,La Bamba,1987,6500000,54215416,47715416
9660,Someone to Watch Over Me,1987,17000000,10278549,-6721451
9665,Project X,1987,18000000,18532286,532286
9669,Throw Momma from the Train,1987,14000000,57915972,43915972
9671,The Monster Squad,1987,12000000,3769990,-8230010
9679,Can't Buy Me Love,1987,1800000,31623833,29823833
9688,Mannequin,1987,6000000,42721196,36721196
9704,Ernest Goes to Camp,1987,3000000,23509382,20509382
9719,2001: A Space Odyssey,1968,12000000,56715371,44715371
9720,Planet of the Apes,1968,5800000,33395426,27595426
9724,Bullitt,1968,5500000,42300873,36800873
9727,Rosemary's Baby,1968,3200000,33395426,30195426
9729,Oliver!,1968,10000000,16800000,6800000
9730,Hang 'em High,1968,1800000,6800000,5000000
9731,Where Eagles Dare,1968,7700000,21000000,13300000
9737,The Green Berets,1968,7000000,11000000,4000000
9756,Charly,1968,950000,814666,-135334
9758,The Godfather: Part II,1974,13000000,47542841,34542841
9759,Chinatown,1974,6000000,30000000,24000000
9760,The Man with the Golden Gun,1974,7000000,97572000,90572000
9761,Young Frankenstein,1974,2800000,86273333,83473333
9764,The Conversation,1974,1600000,4420000,2820000
9767,Blazing Saddles,1974,2600000,119500000,116900000
9769,Airport 1975,1974,3000000,47000000,44000000
9770,The Sugarland Express,1974,3000000,12800000,9800000
9772,The Great Gatsby,1974,6500000,26533200,20033200
9781,Death Wish,1974,3000000,22000000,19000000
9785,The Towering Inferno,1974,14000000,116000000,102000000
9790,Earthquake,1974,7000000,79666653,72666653
9805,One Flew Over the Cuckoo's Nest,1975,3000000,108981275,105981275
9806,Jaws,1975,7000000,470654000,463654000
9808,The Rocky Horror Picture Show,1975,1200000,112892319,111692319
9809,Barry Lyndon,1975,11000000,20000000,9000000
9810,The Return of the Pink Panther,1975,5000000,41833347,36833347
9822,Hard Times,1975,2700000,5000000,2300000
9824,Tommy,1975,5000000,34251525,29251525
9830,Dog Day Afternoon,1975,1800000,46665856,44865856
9849,Dr. No,1962,1100000,59600000,58500000
9850,Lawrence of Arabia,1962,15000000,70000000,55000000
9852,To Kill a Mockingbird,1962,2000000,13129846,11129846
9856,How the West Was Won,1962,15000000,50000000,35000000
9858,The Man Who Shot Liberty Valance,1962,3200000,8000000,4800000
9866,Birdman of Alcatraz,1962,2650000,3100000,450000
9871,The Miracle Worker,1962,500000,2500000,2000000
9881,Goldfinger,1964,3500000,124900000,121400000
9882,Dr. Strangelove or: How I Learned to Stop Worrying and Love the Bomb,1964,1800000,9440272,7640272
9883,Mary Poppins,1964,6000000,102272727,96272727
9884,A Hard Day's Night,1964,500000,1000549,500549
9886,Marnie,1964,2135161,7000000,4864839
9887,My Fair Lady,1964,17000000,72000000,55000000
9905,The Night of the Iguana,1964,3000000,12000000,9000000
9923,A Clockwork Orange,1971,2200000,26589000,24389000
9924,Willy Wonka & the Chocolate Factory,1971,3000000,4000000,1000000
9925,Diamonds Are Forever,1971,7200000,116000000,108800000
9927,Dirty Harry,1971,4000000,35976000,31976000
9928,Escape from the Planet of the Apes,1971,2500000,12348905,9848905
9929,Straw Dogs,1971,2200000,3251794,1051794
9932,THX 1138,1971,777000,2437000,1660000
9934,The French Connection,1971,1800000,41158757,39358757
9935,Play Misty for Me,1971,725000,10600000,9875000
9948,Shaft,1971,4000000,12121618,8121618
9950,Fiddler on the Roof,1971,9000000,10404330,1404330
9951,The Last Picture Show,1971,1300000,29133000,27833000
9952,Vanishing Point,1971,1300000,72266306,70966306
9978,Total Recall,1990,65000000,261317921,196317921
9979,Goodfellas,1990,25000000,46836394,21836394
9980,Die Hard 2,1990,70000000,240031094,170031094
9981,Back to the Future Part III,1990,40000000,244527583,204527583
9982,Edward Scissorhands,1990,20000000,53000000,33000000
9983,Pretty Woman,1990,14000000,463000000,449000000
9984,The Godfather: Part III,1990,54000000,136766062,82766062
9985,Dances with Wolves,1990,22000000,424208848,402208848
9986,Ghost,1990,22000000,505000000,483000000
9987,Teenage Mutant Ninja Turtles,1990,13500000,201965915,188465915
9988,Misery,1990,20000000,61276872,41276872
9989,Rocky V,1990,42000000,119946358,77946358
9990,Child's Play 2,1990,13000000,35763605,22763605
9993,Predator 2,1990,35000000,57120318,22120318
9994,Days of Thunder,1990,60000000,157920733,97920733
9996,Miller's Crossing,1990,14000000,5080409,-8919591
9997,Gremlins 2: The New Batch,1990,50000000,41482207,-8517793
9998,Tremors,1990,11000000,48572000,37572000
9999,RoboCop 2,1990,35000000,45681173,10681173
10000,The Neverending Story II: The Next Chapter,1990,32000000,16283667,-15716333
10003,Another 48 Hrs.,1990,38000000,153518974,115518974
10005,Lionheart,1990,6000000,24078196,18078196
10006,Death Warrant,1990,4000000,16853487,12853487
10011,Wild at Heart,1990,9500000,14560247,5060247
10014,Flatliners,1990,26000000,61489265,35489265
10019,Jacob's Ladder,1990,25000000,25965144,965144
10021,Cry-Baby,1990,11000000,8266343,-2733657
10022,Mo' Better Blues,1990,10000000,16153593,6153593
10023,Dark Angel,1990,7000000,9229401,2229401
10027,Dick Tracy,1990,47000000,103738726,56738726
10028,Darkman,1990,16000000,48878502,32878502
10031,Night of the Living Dead,1990,4200000,5835247,1635247
10035,The Bonfire of the Vanities,1990,47000000,15691192,-31308808
10036,Marked for Death,1990,12000000,46044400,34044400
10039,Kindergarten Cop,1990,15000000,201957688,186957688
10043,King of New York,1990,1000000,2554476,1554476
10044,Graveyard Shift,1990,10500000,11582891,1082891
10046,The Sheltering Sky,1990,25000000,2075084,-22924916
10047,Hardware,1990,1500000,5728953,4228953
10052,Hard to Kill,1990,10000000,47410000,37410000
10055,The Rescuers Down Under,1990,37931000,27931461,-9999539
10068,Nightbreed,1990,11000000,8862354,-2137646
10069,The Two Jakes,1990,19000000,10000000,-9000000
10077,The Adventures of Ford Fairlane,1990,49000000,20423389,-28576611
10081,Mr. Destiny,1990,20000000,15379253,-4620747
10082,Postcards from the Edge,1990,22000000,39071603,17071603
10093,Paris is Burning,1990,500000,3779620,3279620
10094,Home Alone,1990,18000000,476684675,458684675
10095,Mermaids,1990,31000000,35419397,4419397
10096,House Party,1990,2500000,26386000,23886000
10110,One Hundred and One Dalmatians,1961,4000000,215880014,211880014
10111,Breakfast at Tiffany's,1961,2500000,9500000,7000000
10112,West Side Story,1961,6000000,43656822,37656822
10113,The Guns of Navarone,1961,6000000,28900000,22900000
10115,Judgment at Nuremberg,1961,3000000,10000000,7000000
10121,King of Kings,1961,5037000,14483352,9446352
10130,One-Eyed Jacks,1961,6000000,4300000,-1700000
10131,"One, Two, Three",1961,3000000,4000000,1000000
10134,Pocketful of Miracles,1961,2900000,5000000,2100000
10141,Psycho,1960,806948,32000000,31193052
10142,The Magnificent Seven,1960,2000000,4905000,2905000
10143,Spartacus,1960,12000000,60000000,48000000
10144,The Apartment,1960,3000000,25000000,22000000
10170,Cinderfella,1960,3000000,7100000,4100000
10173,Taxi Driver,1976,1300000,28262574,26962574
10174,Rocky,1976,1100000,117235147,116135147
10175,Carrie,1976,1800000,33800000,32000000
10176,The Omen,1976,2800000,60922980,58122980
10177,Logan's Run,1976,9000000,25000000,16000000
10178,King Kong,1976,24000000,52614445,28614445
10179,All the President's Men,1976,8500000,70600000,62100000
10180,The Enforcer,1976,9000000,46236000,37236000
10181,Family Plot,1976,2000000,7900000,5900000
10182,The Outlaw Josey Wales,1976,3700000,31800000,28100000
10183,Marathon Man,1976,6500000,21709020,15209020
10185,Network,1976,3800000,23689877,19889877
10191,The Pink Panther Strikes Again,1976,6000000,33833201,27833201
10208,A Star Is Born,1976,6000000,161000000,155000000
10218,The Bad News Bears,1976,35000000,35323292,323292
10220,Groundhog Day,1993,14600000,70906973,56306973
10221,The Nightmare Before Christmas,1993,18000000,75634409,57634409
10222,Schindler's List,1993,22000000,321265768,299265768
10223,Jurassic Park,1993,63000000,920100000,857100000
10224,Demolition Man,1993,57000000,159055768,102055768
10225,Mrs. Doubtfire,1993,25000000,441286195,416286195
10226,The Fugitive,1993,44000000,368875760,324875760
10227,In the Line of Fire,1993,40000000,176997168,136997168
10228,Philadelphia,1993,26000000,206678440,180678440
10229,Dazed and Confused,1993,6900000,7993039,1093039
10230,Last Action Hero,1993,85000000,137298489,52298489
10231,A Perfect World,1993,30000000,135130999,105130999
10232,Robin Hood: Men in Tights,1993,20000000,35739755,15739755
10234,Cliffhanger,1993,70000000,255000211,185000211
10235,Sliver,1993,40000000,116300000,76300000
10239,Cool Runnings,1993,14000000,154864401,140864401
10240,Sleepless in Seattle,1993,21000000,227799884,206799884
10241,Tombstone,1993,25000000,56505065,31505065
10243,For Love or Money,1993,30000000,11146270,-18853730
10244,Carlito's Way,1993,30000000,36516012,6516012
10245,Hot Shots! Part Deux,1993,25000000,133752825,108752825
10246,True Romance,1993,12500000,12281551,-218449
10247,Super Mario Bros.,1993,42000000,20844907,-21155093
10248,Sister Act 2: Back in the Habit,1993,38000000,57319029,19319029
10250,The Pelican Brief,1993,45000000,195268056,150268056
10251,The Three Musketeers,1993,30000000,53898845,23898845
10252,RoboCop 3,1993,22000000,10696210,-11303790
10253,What's Eating Gilbert Grape,1993,11000000,30000000,19000000
10254,Dennis the Menace,1993,35000000,117270765,82270765
10255,Kalifornia,1993,9000000,2395231,-6604769
10256,A Bronx Tale,1993,22000000,17287898,-4712102
10257,Manhattan Murder Mystery,1993,13500000,11285588,-2214412
10258,Falling Down,1993,25000000,40903593,15903593
10260,The Firm,1993,42000000,270248367,228248367
10261,The Dark Half,1993,15000000,10611160,-4388840
10263,Hocus Pocus,1993,28000000,39514713,11514713
10265,In the Name of the Father,1993,13000000,65796862,52796862
10267,Free Willy,1993,20000000,153698625,133698625
10274,The Piano,1993,7000000,116700000,109700000
10275,Geronimo: An American Legend,1993,35000000,18635620,-16364380
10279,The Good Son,1993,17000000,44456478,27456478
10281,Hard Target,1993,18000000,74189677,56189677
10282,The Remains of the Day,1993,11500000,23237911,11737911
10283,Batman: Mask of the Phantasm,1993,6000000,5617391,-382609
10284,The Age of Innocence,1993,34000000,32255440,-1744560
10291,Alive,1993,32000000,36733909,4733909
10299,Rudy,1993,12000000,22750363,10750363
10303,Beethoven's 2nd,1993,15000000,118243066,103243066
10306,So I Married an Axe Murderer,1993,20000000,11585483,-8414517
10312,Indecent Proposal,1993,38000000,266614059,228614059
10315,Menace II Society,1993,3500000,27900000,24400000
10317,Body of Evidence,1993,30000000,13273595,-16726405
10323,Red Rock West,1993,8000000,2000000,-6000000
10327,Leprechaun,1993,900000,8556940,7656940
10331,Son of the Pink Panther,1993,25000000,2438031,-22561969
10335,Little Buddha,1993,35000000,4858139,-30141861
10338,Poetic Justice,1993,14000000,27515786,13515786
10344,Children of the Corn II: The Final Sacrifice,1993,900000,6980986,6080986
10348,The Joy Luck Club,1993,11000000,32861136,21861136
10354,The Crush,1993,6000000,13609396,7609396
10355,Fire in the Sky,1993,19885552,19724334,-161218
10364,Only the Strong,1993,6000000,3283371,-2716629
10368,Man's Best Friend,1993,6000000,12974636,6974636
10378,Dragon: The Bruce Lee Story,1993,14000000,63513743,49513743
10391,Xi yan,1993,1000000,6933459,5933459
10398,The Jungle Book,1967,4000000,205843612,201843612
10399,The Graduate,1967,3000000,104397102,101397102
10400,Casino Royale,1967,12000000,41744718,29744718
10401,You Only Live Twice,1967,9500000,111584787,102084787
10402,Bonnie and Clyde,1967,2500000,50700000,48200000
10404,Cool Hand Luke,1967,3000000,16217773,13217773
10405,Wait Until Dark,1967,4000000,11000000,7000000
10409,The Dirty Dozen,1967,25000000,45300000,20300000
10410,In the Heat of the Night,1967,2000000,27379978,25379978
10413,Guess Who's Coming to Dinner,1967,4000000,56666667,52666667
10418,Doctor Dolittle,1967,18000000,9000000,-9000000
10420,Valley of the Dolls,1967,5000000,50000000,45000000
10425,A Countess from Hong Kong,1967,3500000,2000000,-1500000
10438,From Russia With Love,1963,2500000,78898765,76398765
10440,The Birds,1963,2500000,11403529,8903529
10441,Charade,1963,4000000,13474588,9474588
10443,Cleopatra,1963,31115000,57750000,26635000
10446,The Great Escape,1963,4000000,5000000,1000000
10457,55 Days at Peking,1963,17000000,10000000,-7000000
10472,Aliens,1986,18500000,131060248,112560248
10473,Highlander,1986,16000000,5900000,-10100000
10474,Platoon,1986,6000000,138530565,132530565
10475,Top Gun,1986,15000000,356830601,341830601
10476,Ferris Bueller's Day Off,1986,6000000,70136369,64136369
10477,Stand by Me,1986,8000000,52287000,44287000
10480,The Fly,1986,15000000,60629159,45629159
10481,Nine 1/2 Weeks,1986,17000000,6735922,-10264078
10482,The Great Mouse Detective,1986,14000000,82424789,68424789
10483,Pirates,1986,40000000,1641825,-38358175
10486,Blue Velvet,1986,6000000,8551228,2551228
10487,Star Trek IV: The Voyage Home,1986,24000000,133000000,109000000
10488,Howard the Duck,1986,37000000,37962774,962774
10489,Big Trouble in Little China,1986,25000000,11000000,-14000000
10490,The Color of Money,1986,13800000,52293982,38493982
10491,The Name of the Rose,1986,20000000,77200000,57200000
10492,Labyrinth,1986,25000000,12729917,-12270083
10498,Raw Deal,1986,8500000,16209459,7709459
10499,Crocodile Dundee,1986,5000000,328203506,323203506
10500,Heartbreak Ridge,1986,15000000,42724017,27724017
10501,The Golden Child,1986,25000000,79817939,54817939
10503,Poltergeist II: The Other Side,1986,19000000,40996665,21996665
10504,The Money Pit,1986,10000000,54999651,44999651
10505,Little Shop of Horrors,1986,25000000,38748395,13748395
10507,The Mission,1986,24500000,17218023,-7281977
10508,Hoosiers,1986,9000000,28607524,19607524
10509,Friday the 13th Part VI: Jason Lives,1986,3000000,19472057,16472057
10511,From Beyond,1986,4500000,1261000,-3239000
10514,Critters,1986,2000000,13167232,11167232
10516,Sid & Nancy,1986,4000000,2826523,-1173477
10519,Hannah and Her Sisters,1986,6400000,40084041,33684041
10521,King Kong Lives,1986,10000000,4711220,-5288780
10525,Down and Out in Beverly Hills,1986,14000000,62134225,48134225
10527,Maximum Overdrive,1986,10000000,7433663,-2566337
10528,A Room with a View,1986,3000000,20966644,17966644
10530,Peggy Sue Got Married,1986,18000000,41382841,23382841
10539,The Wraith,1986,2700000,3500000,800000
10541,The Texas Chainsaw Massacre 2,1986,4700000,8025872,3325872
10552,Invaders from Mars,1986,12000000,4884663,-7115337
10556,The Manhattan Project,1986,18000000,3900000,-14100000
10558,At Close Range,1986,6500000,2347000,-4153000
10566,Troll,1986,1100000,5450815,4350815
10572,Armed and Dangerous,1986,12000000,15945534,3945534
10578,Club Paradise,1986,15000000,12308521,-2691479
10584,SpaceCamp,1986,18000000,9697739,-8302261
10588,Vamp,1986,1900000,4790926,2890926
10589,Manhunter,1986,15000000,8620929,-6379071
10593,Robin Hood,1973,15000000,32056467,17056467
10594,The Exorcist,1973,8000000,441306145,433306145
10595,Live and Let Die,1973,7000000,161777836,154777836
10596,Mean Streets,1973,500000,3000000,2500000
10597,Enter the Dragon,1973,850000,90000000,89150000
10599,Battle for the Planet of the Apes,1973,1700000,8844595,7144595
10601,The Sting,1973,5500000,159616327,154116327
10606,American Graffiti,1973,777000,115000000,114223000
10608,Papillon,1973,12000000,53267000,41267000
10609,Sleeper,1973,2000000,18344729,16344729
10611,Serpico,1973,3000000,29800000,26800000
10647,Dillinger,1973,1000000,2000000,1000000
10648,The Aristocats,1970,4000000,55675257,51675257
10649,Beneath the Planet of the Apes,1970,3000000,18999718,15999718
10650,MASH,1970,3500000,81600000,78100000
10653,Patton,1970,12000000,89800000,77800000
10654,Love Story,1970,2200000,136400000,134200000
10656,Tora! Tora! Tora!,1970,25485000,29548291,4063291
10660,Airport,1970,10000000,100489151,90489151
10661,Zabriskie Point,1970,7000000,900000,-6100000
10665,Little Big Man,1970,15000000,31559552,16559552
10675,The Ballad of Cable Hogue,1970,3716946,3500000,-216946
10683,The Private Life of Sherlock Holmes,1970,10000000,1500000,-8500000
10689,Thunderball,1965,11000000,141195658,130195658
10690,The Sound of Music,1965,8200000,163214286,155014286
10691,Doctor Zhivago,1965,14000000,111721910,97721910
10692,Those Magnificent Men in Their Flying Machines or How I Flew from London to Paris in 25 hours 11 minutes,1965,5600000,29950000,24350000
10716,The Greatest Story Ever Told,1965,20000000,12000000,-8000000
10724,On Her Majesty's Secret Service,1969,7000000,81974493,74974493
10725,Butch Cassidy and the Sundance Kid,1969,6000000,102308889,96308889
10727,Midnight Cowboy,1969,3600000,44785053,41185053
10728,The Wild Bunch,1969,6244087,638641,-5605446
10755,Grease,1978,6000000,181813770,175813770
10756,Jaws 2,1978,20000000,187884007,167884007
10757,Dawn of the Dead,1978,650000,55000000,54350000
10758,Superman,1978,55000000,300218018,245218018
10760,Animal House,1978,2700000,141000000,138300000
10762,The Deer Hunter,1978,15000000,50000000,35000000
10770,Midnight Express,1978,2300000,35000000,32700000
10771,The Lord of the Rings,1978,4000000,30471420,26471420
10775,Death on the Nile,1978,7920000,14560084,6640084
10778,Force 10 from Navarone,1978,5000000,7230000,2230000
10779,Convoy,1978,12000000,22765081,10765081
10780,Invasion of the Body Snatchers,1978,3500000,24046533,20546533
10788,The Wiz,1978,24000000,21049053,-2950947
10791,Damien: Omen II,1978,6800000,26518355,19718355
10793,Watership Down,1978,1000000,3713768,2713768
10822,Who's Afraid of Virginia Woolf?,1966,7500000,33736689,26236689
10828,Torn Curtain,1966,3000000,13000000,10000000
10829,El Dorado,1966,4653000,6000000,1347000
10835,The Sand Pebbles,1966,12000000,20000000,8000000
10848,Fantastic Voyage,1966,5115000,12000000,6885000
